a	alphabet
i	alphabet
t	alphabet
s	alphabet
j	alphabet
v	alphabet
o	alphabet
m	alphabet
f	alphabet
e	alphabet
n	alphabet
r	alphabet
c	alphabet
d	alphabet
p	alphabet
l	alphabet
h	alphabet
b	alphabet
w	alphabet
x	alphabet
u	alphabet
g	alphabet
y	alphabet
k	alphabet
q	alphabet
z	alphabet
the	englishfunction
of	englishfunction
and	englishfunction
in	englishfunction
to	englishfunction
by	englishfunction
on	englishfunction
for	englishfunction
it	englishfunction
at	englishfunction
from	englishfunction
with	englishfunction
an	englishfunction
is	englishfunction
as	englishfunction
this	englishfunction
his	englishfunction
he	englishfunction
so	englishfunction
no	englishfunction
one	englishfunction
that	englishfunction
or	englishfunction
if	englishfunction
when	englishfunction
we	englishfunction
not	englishfunction
there	englishfunction
but	englishfunction
after	englishfunction
their	englishfunction
they	englishfunction
what	englishfunction
be	englishfunction
its	englishfunction
our	englishfunction
these	englishfunction
my	englishfunction
before	englishfunction
do	englishfunction
then	englishfunction
under	englishfunction
who	englishfunction
where	englishfunction
upon	englishfunction
those	englishfunction
will	englishfunction
are	englishfunction
her	englishfunction
which	englishfunction
more	englishfunction
was	englishfunction
you	englishfunction
yet	englishfunction
have	englishfunction
had	englishfunction
among	englishfunction
nor	englishfunction
about	englishfunction
without	englishfunction
having	englishfunction
though	englishfunction
being	englishfunction
she	englishfunction
were	englishfunction
through	englishfunction
why	englishfunction
out	englishfunction
any	englishfunction
between	englishfunction
whether	englishfunction
would	englishfunction
should	englishfunction
your	englishfunction
however	englishfunction
has	englishfunction
up	englishfunction
did	englishfunction
within	englishfunction
am	englishfunction
over	englishfunction
me	englishfunction
shall	englishfunction
him	englishfunction
into	englishfunction
could	englishfunction
besides	englishfunction
although	englishfunction
whatever	englishfunction
above	englishfunction
against	englishfunction
down	englishfunction
us	englishfunction
whose	englishfunction
than	englishfunction
whom	englishfunction
thou	englishfunction
them	englishfunction
himself	englishfunction
towards	englishfunction
off	englishfunction
along	englishfunction
been	englishfunction
below	englishfunction
behind	englishfunction
throughout	englishfunction
around	englishfunction
mine	englishfunction
thy	englishfunction
itself	englishfunction
themselves	englishfunction
ye	englishfunction
across	englishfunction
myself	englishfunction
thee	englishfunction
whilst	englishfunction
amongst	englishfunction
ourselves	englishfunction
herself	englishfunction
unto	englishfunction
tis	englishfunction
don't	englishfunction
hast	englishfunction
new	inGoldstone
all	inGoldstone
first	inGoldstone
two	inGoldstone
some	inGoldstone
how	inGoldstone
now	inGoldstone
here	inGoldstone
old	inGoldstone
such	inGoldstone
every	inGoldstone
three	inGoldstone
thus	inGoldstone
while	inGoldstone
let	inGoldstone
other	inGoldstone
another	inGoldstone
second	inGoldstone
most	inGoldstone
each	inGoldstone
even	inGoldstone
both	inGoldstone
can	inGoldstone
only	inGoldstone
since	inGoldstone
during	inGoldstone
well	inGoldstone
nothing	inGoldstone
like	inGoldstone
little	inGoldstone
very	inGoldstone
still	inGoldstone
again	inGoldstone
go	inGoldstone
take	inGoldstone
much	inGoldstone
never	inGoldstone
just	inGoldstone
perhaps	inGoldstone
four	inGoldstone
last	inGoldstone
indeed	inGoldstone
third	inGoldstone
come	inGoldstone
once	inGoldstone
several	inGoldstone
neither	inGoldstone
others	inGoldstone
next	inGoldstone
right	inGoldstone
none	inGoldstone
according	inGoldstone
far	inGoldstone
few	inGoldstone
five	inGoldstone
com	inGoldstone
does	inGoldstone
therefore	inGoldstone
also	inGoldstone
sometimes	inGoldstone
because	inGoldstone
six	inGoldstone
look	inGoldstone
too	inGoldstone
instead	inGoldstone
near	inGoldstone
use	inGoldstone
say	inGoldstone
hence	inGoldstone
must	inGoldstone
certain	inGoldstone
ever	inGoldstone
almost	inGoldstone
until	inGoldstone
various	inGoldstone
way	inGoldstone
beyond	inGoldstone
either	inGoldstone
name	inGoldstone
think	inGoldstone
tell	inGoldstone
seven	inGoldstone
further	inGoldstone
know	inGoldstone
better	inGoldstone
keep	inGoldstone
except	inGoldstone
certainly	inGoldstone
often	inGoldstone
nearly	inGoldstone
might	inGoldstone
same	inGoldstone
said	inGoldstone
given	inGoldstone
whole	inGoldstone
away	inGoldstone
best	inGoldstone
following	inGoldstone
already	inGoldstone
probably	inGoldstone
cause	inGoldstone
something	inGoldstone
always	inGoldstone
eight	inGoldstone
less	inGoldstone
unless	inGoldstone
taken	inGoldstone
together	inGoldstone
different	inGoldstone
own	inGoldstone
rather	inGoldstone
mr	inGoldstone
course	inGoldstone
enough	inGoldstone
alone	inGoldstone
done	inGoldstone
believe	inGoldstone
quite	inGoldstone
get	inGoldstone
came	inGoldstone
cannot	inGoldstone
sent	inGoldstone
hi	inGoldstone
looking	inGoldstone
want	inGoldstone
going	inGoldstone
known	inGoldstone
value	inGoldstone
seen	inGoldstone
mean	inGoldstone
nine	inGoldstone
whenever	inGoldstone
sure	inGoldstone
used	inGoldstone
later	inGoldstone
need	inGoldstone
accordingly	inGoldstone
especially	inGoldstone
seeing	inGoldstone
forth	inGoldstone
consider	inGoldstone
afterwards	inGoldstone
ask	inGoldstone
saw	inGoldstone
comes	inGoldstone
help	inGoldstone
went	inGoldstone
truly	inGoldstone
whence	inGoldstone
gives	inGoldstone
become	inGoldstone
otherwise	inGoldstone
kept	inGoldstone
took	inGoldstone
fifth	inGoldstone
nevertheless	inGoldstone
dr	inGoldstone
placed	inGoldstone
former	inGoldstone
particular	inGoldstone
ought	inGoldstone
least	inGoldstone
able	inGoldstone
gone	inGoldstone
yes	inGoldstone
wherever	inGoldstone
necessary	inGoldstone
try	inGoldstone
seems	inGoldstone
appear	inGoldstone
says	inGoldstone
twice	inGoldstone
example	inGoldstone
seem	inGoldstone
causes	inGoldstone
possible	inGoldstone
allow	inGoldstone
wish	inGoldstone
latter	inGoldstone
really	inGoldstone
hardly	inGoldstone
formerly	inGoldstone
followed	inGoldstone
moreover	inGoldstone
self	inGoldstone
became	inGoldstone
concerning	inGoldstone
doing	inGoldstone
entirely	inGoldstone
changes	inGoldstone
containing	inGoldstone
goes	inGoldstone
please	inGoldstone
somewhat	inGoldstone
thence	inGoldstone
useful	inGoldstone
merely	inGoldstone
apart	inGoldstone
sup	inGoldstone
got	inGoldstone
thanks	inGoldstone
everything	inGoldstone
brief	inGoldstone
usually	inGoldstone
becomes	inGoldstone
mo	inGoldstone
considering	inGoldstone
particularly	inGoldstone
saying	inGoldstone
aside	inGoldstone
ones	inGoldstone
tried	inGoldstone
clearly	inGoldstone
follows	inGoldstone
wonder	inGoldstone
exactly	inGoldstone
seemed	inGoldstone
whereas	inGoldstone
immediate	inGoldstone
consequently	inGoldstone
described	inGoldstone
serious	inGoldstone
outside	inGoldstone
beside	inGoldstone
ar	inGoldstone
knows	inGoldstone
lest	inGoldstone
willing	inGoldstone
likely	inGoldstone
looks	inGoldstone
becoming	inGoldstone
thank	inGoldstone
contains	inGoldstone
welcome	inGoldstone
anything	inGoldstone
wants	inGoldstone
lately	inGoldstone
actually	inGoldstone
contain	inGoldstone
thoroughly	inGoldstone
elsewhere	inGoldstone
di	inGoldstone
getting	inGoldstone
mrs	inGoldstone
unfortunately	inGoldstone
selves	inGoldstone
using	inGoldstone
yours	inGoldstone
ours	inGoldstone
id	inGoldstone
toward	inGoldstone
needs	inGoldstone
everywhere	inGoldstone
uses	inGoldstone
hereafter	inGoldstone
thereby	inGoldstone
wherein	inGoldstone
meanwhile	inGoldstone
whoever	inGoldstone
trying	inGoldstone
sensible	inGoldstone
secondly	inGoldstone
nobody	inGoldstone
keeps	inGoldstone
corresponding	inGoldstone
asking	inGoldstone
inner	inGoldstone
ca	inGoldstone
regarding	inGoldstone
appropriate	inGoldstone
whither	inGoldstone
seriously	inGoldstone
therein	inGoldstone
theirs	inGoldstone
yourself	inGoldstone
associated	inGoldstone
viz	inGoldstone
thorough	inGoldstone
ms	inGoldstone
regards	inGoldstone
namely	inGoldstone
indicated	inGoldstone
sorry	inGoldstone
indicate	inGoldstone
happens	inGoldstone
novel	inGoldstone
ia	inGoldstone
hither	inGoldstone
mostly	inGoldstone
nowhere	inGoldstone
seeming	inGoldstone
gets	inGoldstone
somewhere	inGoldstone
whereby	inGoldstone
everybody	inGoldstone
cf	inGoldstone
inasmuch	inGoldstone
tends	inGoldstone
mainly	inGoldstone
os	inGoldstone
inward	inGoldstone
appreciate	inGoldstone
anywhere	inGoldstone
respectively	inGoldstone
hers	inGoldstone
liked	inGoldstone
whereupon	inGoldstone
allows	inGoldstone
thereupon	inGoldstone
wa	inGoldstone
reasonably	inGoldstone
available	inGoldstone
indicates	inGoldstone
yourselves	inGoldstone
nd	inGoldstone
herein	inGoldstone
maybe	inGoldstone
tn	inGoldstone
despite	inGoldstone
obviously	inGoldstone
ie	inGoldstone
somebody	inGoldstone
specified	inGoldstone
tries	inGoldstone
gotten	inGoldstone
ct	inGoldstone
ri	inGoldstone
regardless	inGoldstone
via	inGoldstone
plus	inGoldstone
beforehand	inGoldstone
wi	inGoldstone
hereby	inGoldstone
somehow	inGoldstone
dc	inGoldstone
sc	inGoldstone
cant	inGoldstone
sometime	inGoldstone
anybody	inGoldstone
downwards	inGoldstone
provides	inGoldstone
fl	inGoldstone
thereafter	inGoldstone
unlikely	inGoldstone
une	inGoldstone
mt	inGoldstone
definitely	inGoldstone
ga	inGoldstone
md	inGoldstone
furthermore	inGoldstone
vt	inGoldstone
anyone	inGoldstone
ny	inGoldstone
vs	inGoldstone
relatively	inGoldstone
latterly	inGoldstone
everyone	inGoldstone
ignored	inGoldstone
specify	inGoldstone
mn	inGoldstone
awfully	inGoldstone
anyhow	inGoldstone
nc	inGoldstone
greetings	inGoldstone
sd	inGoldstone
zero	inGoldstone
hereupon	inGoldstone
ky	inGoldstone
rd	inGoldstone
eg	inGoldstone
presumably	inGoldstone
specifying	inGoldstone
inc	inGoldstone
ks	inGoldstone
nm	inGoldstone
howbeit	inGoldstone
tx	inGoldstone
hopefully	inGoldstone
onto	inGoldstone
nj	inGoldstone
anyway	inGoldstone
wy	inGoldstone
ak	inGoldstone
nv	inGoldstone
someone	inGoldstone
currently	inGoldstone
normally	inGoldstone
ltd	inGoldstone
wv	inGoldstone
az	inGoldstone
nh	inGoldstone
hello	inGoldstone
thru	inGoldstone
overall	inGoldstone
anyways	inGoldstone
thats	inGoldstone
insofar	inGoldstone
whereafter	inGoldstone
okay	inGoldstone
uucp	inGoldstone
theres	inGoldstone
thanx	inGoldstone
qv	inGoldstone
edu	inGoldstone
may	inUnderwood
many	inUnderwood
man	inUnderwood
see	inUnderwood
long	inUnderwood
king	inUnderwood
young	inUnderwood
re	inUnderwood
art	inUnderwood
soon	inUnderwood
page	inUnderwood
love	inUnderwood
st	inUnderwood
hope	inUnderwood
co	inUnderwood
chapter	inUnderwood
mark	inUnderwood
royal	inUnderwood
sun	inUnderwood
lady	inUnderwood
faith	inUnderwood
spring	inUnderwood
rich	inUnderwood
vol	inUnderwood
prince	inUnderwood
volume	inUnderwood
introduction	inUnderwood
rose	inUnderwood
liberty	inUnderwood
grace	inUnderwood
queen	inUnderwood
grant	inUnderwood
winter	inUnderwood
noble	inUnderwood
op	inUnderwood
th	inUnderwood
summer	inUnderwood
numbers	inUnderwood
ward	inUnderwood
desire	inUnderwood
ed	inUnderwood
golden	inUnderwood
carry	inUnderwood
else	inUnderwood
miles	inUnderwood
christian	inUnderwood
temple	inUnderwood
glory	inUnderwood
joy	inUnderwood
miss	inUnderwood
ing	inUnderwood
chance	inUnderwood
mercy	inUnderwood
august	inUnderwood
bell	inUnderwood
bill	inUnderwood
song	inUnderwood
col	inUnderwood
drew	inUnderwood
em	inUnderwood
season	inUnderwood
france	inUnderwood
forest	inUnderwood
star	inUnderwood
patience	inUnderwood
don	inUnderwood
roman	inUnderwood
charity	inUnderwood
moon	inUnderwood
america	inUnderwood
preface	inUnderwood
precious	inUnderwood
earnest	inUnderwood
june	inUnderwood
bo	inUnderwood
sion	inUnderwood
german	inUnderwood
major	inUnderwood
paris	inUnderwood
na	inUnderwood
april	inUnderwood
hung	inUnderwood
clay	inUnderwood
pa	inUnderwood
harmony	inUnderwood
etc	inUnderwood
eve	inUnderwood
hang	inUnderwood
angel	inUnderwood
gay	inUnderwood
chap	inUnderwood
autumn	inUnderwood
january	inUnderwood
ray	inUnderwood
chase	inUnderwood
september	inUnderwood
earl	inUnderwood
india	inUnderwood
sunday	inUnderwood
prudence	inUnderwood
tory	inUnderwood
brain	inUnderwood
oi	inUnderwood
conception	inUnderwood
sage	inUnderwood
dawn	inUnderwood
merry	inUnderwood
yon	inUnderwood
lane	inUnderwood
china	inUnderwood
marry	inUnderwood
brook	inUnderwood
rod	inUnderwood
hue	inUnderwood
irish	inUnderwood
princess	inUnderwood
manual	inUnderwood
there's	inUnderwood
porter	inUnderwood
destiny	inUnderwood
lean	inUnderwood
sung	inUnderwood
ami	inUnderwood
jesus	inUnderwood
ben	inUnderwood
ai	inUnderwood
rocky	inUnderwood
it's	inUnderwood
sunshine	inUnderwood
pp	inUnderwood
echo	inUnderwood
bee	inUnderwood
loan	inUnderwood
hunter	inUnderwood
dean	inUnderwood
victor	inUnderwood
angle	inUnderwood
honey	inUnderwood
sang	inUnderwood
ling	inUnderwood
can't	inUnderwood
fe	inUnderwood
ana	inUnderwood
marine	inUnderwood
stormy	inUnderwood
scarlet	inUnderwood
sue	inUnderwood
penny	inUnderwood
gene	inUnderwood
sterling	inUnderwood
asia	inUnderwood
trinity	inUnderwood
abbey	inUnderwood
sandy	inUnderwood
marquis	inUnderwood
diamond	inUnderwood
gale	inUnderwood
fig	inUnderwood
i'll	inUnderwood
ken	inUnderwood
fairy	inUnderwood
virginia	inUnderwood
rea	inUnderwood
reed	inUnderwood
he's	inUnderwood
olive	inUnderwood
cherish	inUnderwood
pearl	inUnderwood
crystal	inUnderwood
mason	inUnderwood
ted	inUnderwood
israel	inUnderwood
heath	inUnderwood
vols	inUnderwood
lin	inUnderwood
kent	inUnderwood
won't	inUnderwood
we'll	inUnderwood
sunny	inUnderwood
lu	inUnderwood
beau	inUnderwood
min	inUnderwood
dale	inUnderwood
chin	inUnderwood
velvet	inUnderwood
florence	inUnderwood
venice	inUnderwood
junior	inUnderwood
venus	inUnderwood
pat	inUnderwood
ivory	inUnderwood
prof	inUnderwood
melody	inUnderwood
blossom	inUnderwood
wan	inUnderwood
bud	inUnderwood
ok	inUnderwood
terra	inUnderwood
ibid	inUnderwood
lore	inUnderwood
caprice	inUnderwood
marvel	inUnderwood
tiny	inUnderwood
brandy	inUnderwood
troy	inUnderwood
sol	inUnderwood
sal	inUnderwood
cliff	inUnderwood
lily	inUnderwood
laurel	inUnderwood
violet	inUnderwood
jewel	inUnderwood
lance	inUnderwood
freeman	inUnderwood
scot	inUnderwood
carolina	inUnderwood
eden	inUnderwood
easter	inUnderwood
belle	inUnderwood
rosy	inUnderwood
ping	inUnderwood
lea	inUnderwood
alexandria	inUnderwood
berry	inUnderwood
nova	inUnderwood
geneva	inUnderwood
ivy	inUnderwood
willow	inUnderwood
glen	inUnderwood
mai	inUnderwood
dia	inUnderwood
georgia	inUnderwood
cherry	inUnderwood
flora	inUnderwood
jordan	inUnderwood
genesis	inUnderwood
vita	inUnderwood
dusty	inUnderwood
ian	inUnderwood
kirk	inUnderwood
florida	inUnderwood
coral	inUnderwood
dot	inUnderwood
raven	inUnderwood
garland	inUnderwood
vance	inUnderwood
austin	inUnderwood
chastity	inUnderwood
maryland	inUnderwood
lang	inUnderwood
angelic	inUnderwood
rusty	inUnderwood
amber	inUnderwood
iris	inUnderwood
francisco	inUnderwood
bart	inUnderwood
fern	inUnderwood
dell	inUnderwood
misty	inUnderwood
herb	inUnderwood
beth	inUnderwood
aurora	inUnderwood
ike	inUnderwood
vince	inUnderwood
they'll	inUnderwood
nu	inUnderwood
nan	inUnderwood
emerald	inUnderwood
fay	inUnderwood
leicester	inUnderwood
sparkle	inUnderwood
alia	inUnderwood
garret	inUnderwood
ora	inUnderwood
cleveland	inUnderwood
rex	inUnderwood
trent	inUnderwood
bert	inUnderwood
ara	inUnderwood
ruby	inUnderwood
myrtle	inUnderwood
thu	inUnderwood
maple	inUnderwood
wen	inUnderwood
hazel	inUnderwood
ron	inUnderwood
nia	inUnderwood
dung	inUnderwood
lien	inUnderwood
alma	inUnderwood
windy	inUnderwood
fawn	inUnderwood
yer	inUnderwood
ming	inUnderwood
holly	inUnderwood
mari	inUnderwood
mora	inUnderwood
ka	inUnderwood
meta	inUnderwood
peg	inUnderwood
tawny	inUnderwood
gloria	inUnderwood
canto	inUnderwood
delta	inUnderwood
len	inUnderwood
chelsea	inUnderwood
dane	inUnderwood
pearly	inUnderwood
alba	inUnderwood
cher	inUnderwood
piper	inUnderwood
eliot	inUnderwood
coy	inUnderwood
daisy	inUnderwood
ebony	inUnderwood
toi	inUnderwood
sierra	inUnderwood
aide	inUnderwood
ginger	inUnderwood
rick	inUnderwood
savannah	inUnderwood
viva	inUnderwood
della	inUnderwood
ute	inUnderwood
alpha	inUnderwood
heather	inUnderwood
carol	inUnderwood
maxima	inUnderwood
lia	inUnderwood
brittany	inUnderwood
luna	inUnderwood
bonny	inUnderwood
angeles	inUnderwood
gala	inUnderwood
candi	inUnderwood
sherry	inUnderwood
mia	inUnderwood
hee	inUnderwood
ina	inUnderwood
tia	inUnderwood
sid	inUnderwood
jade	inUnderwood
mica	inUnderwood
hai	inUnderwood
rae	inUnderwood
ria	inUnderwood
shan't	inUnderwood
soo	inUnderwood
mei	inUnderwood
hae	inUnderwood
lino	inUnderwood
hank	inUnderwood
aura	inUnderwood
carmine	inUnderwood
regina	inUnderwood
shad	inUnderwood
flor	inUnderwood
patria	inUnderwood
lai	inUnderwood
dallas	inUnderwood
candy	inUnderwood
houston	inUnderwood
nevada	inUnderwood
avis	inUnderwood
maris	inUnderwood
bea	inUnderwood
univ	inUnderwood
sherwood	inUnderwood
tad	inUnderwood
noe	inUnderwood
shin	inUnderwood
yen	inUnderwood
hyacinth	inUnderwood
thea	inUnderwood
tiara	inUnderwood
lue	inUnderwood
abe	inUnderwood
mee	inUnderwood
tai	inUnderwood
rosemary	inUnderwood
garnet	inUnderwood
alta	inUnderwood
bonnie	inUnderwood
trinidad	inUnderwood
ranee	inUnderwood
elba	inUnderwood
opal	inUnderwood
magnolia	inUnderwood
ima	inUnderwood
omega	inUnderwood
stanford	inUnderwood
aurea	inUnderwood
chuck	inUnderwood
mana	inUnderwood
dulce	inUnderwood
dirk	inUnderwood
jarred	inUnderwood
vena	inUnderwood
pasty	inUnderwood
tana	inUnderwood
tina	inUnderwood
carmina	inUnderwood
signe	inUnderwood
yu	inUnderwood
sana	inUnderwood
jasmine	inUnderwood
dimple	inUnderwood
nubia	inUnderwood
tori	inUnderwood
latina	inUnderwood
inge	inUnderwood
erick	inUnderwood
nana	inUnderwood
genie	inUnderwood
tien	inUnderwood
athena	inUnderwood
shelly	inUnderwood
kali	inUnderwood
chere	inUnderwood
kam	inUnderwood
ester	inUnderwood
beryl	inUnderwood
agnus	inUnderwood
jung	inUnderwood
cari	inUnderwood
tierra	inUnderwood
meri	inUnderwood
lory	inUnderwood
alla	inUnderwood
lise	inUnderwood
illa	inUnderwood
digna	inUnderwood
joie	inUnderwood
lana	inUnderwood
vina	inUnderwood
cris	inUnderwood
rosette	inUnderwood
rima	inUnderwood
nona	inUnderwood
chu	inUnderwood
beata	inUnderwood
hui	inUnderwood
tera	inUnderwood
yee	inUnderwood
manda	inUnderwood
sade	inUnderwood
yong	inUnderwood
maye	inUnderwood
sommer	inUnderwood
monet	inUnderwood
manie	inUnderwood
pansy	inUnderwood
mavis	inUnderwood
dann	inUnderwood
marge	inUnderwood
justa	inUnderwood
laine	inUnderwood
tess	inUnderwood
riva	inUnderwood
hye	inUnderwood
amie	inUnderwood
rocco	inUnderwood
novella	inUnderwood
avril	inUnderwood
zona	inUnderwood
deja	inUnderwood
carina	inUnderwood
joye	inUnderwood
concha	inUnderwood
chia	inUnderwood
chrystal	inUnderwood
sook	inUnderwood
dahlia	inUnderwood
tari	inUnderwood
dina	inUnderwood
dong	inUnderwood
gracia	inUnderwood
sima	inUnderwood
fidel	inUnderwood
bong	inUnderwood
felicitas	inUnderwood
cori	inUnderwood
liana	inUnderwood
darin	inUnderwood
verna	inUnderwood
ching	inUnderwood
kala	inUnderwood
sean	inUnderwood
kum	inUnderwood
toni	inUnderwood
savanna	inUnderwood
trey	inUnderwood
jene	inUnderwood
gena	inUnderwood
ethyl	inUnderwood
gina	inUnderwood
crista	inUnderwood
cordia	inUnderwood
birdie	inUnderwood
tena	inUnderwood
jolie	inUnderwood
chante	inUnderwood
linsey	inUnderwood
doloris	inUnderwood
trina	inUnderwood
loris	inUnderwood
burl	inUnderwood
ione	inUnderwood
carie	inUnderwood
carline	inUnderwood
lauri	inUnderwood
lala	inUnderwood
karma	inUnderwood
carri	inUnderwood
raye	inUnderwood
sonny	inUnderwood
cristal	inUnderwood
celsa	inUnderwood
modesta	inUnderwood
kris	inUnderwood
margo	inUnderwood
aurore	inUnderwood
mandi	inUnderwood
buffy	inUnderwood
lupe	inUnderwood
daine	inUnderwood
alise	inUnderwood
billie	inUnderwood
refugio	inUnderwood
liane	inUnderwood
vanna	inUnderwood
dalia	inUnderwood
deon	inUnderwood
misti	inUnderwood
delaine	inUnderwood
nida	inUnderwood
cira	inUnderwood
bruna	inUnderwood
marita	inUnderwood
alleen	inUnderwood
rosaria	inUnderwood
elke	inUnderwood
glady	inUnderwood
candis	inUnderwood
alica	inUnderwood
latrina	inUnderwood
cordwain	inUnderwood
yuk	inUnderwood
brandie	inUnderwood
minh	inUnderwood
lavera	inUnderwood
alita	inUnderwood
tequila	inUnderwood
jodi	inUnderwood
anja	inUnderwood
melodi	inUnderwood
refugia	inUnderwood
versie	inUnderwood
bambi	inUnderwood
porsche	inUnderwood
qiana	inUnderwood
wordcounts	inUnderwood
tive	inUnderwood
tions	inUnderwood
tion	inUnderwood
thi	inUnderwood
ona	inUnderwood
oma	inUnderwood
ji	inUnderwood
ity	inUnderwood
isreal	inUnderwood
isa	inUnderwood
divina	inUnderwood
cuc	inUnderwood
force	french
ma	french
par	french
mon	french
sur	french
au	french
car	french
est	french
il	french
du	french
ton	french
pour	french
des	french
pas	french
sa	french
ou	french
ta	french
comment	french
je	french
ce	french
bon	french
eu	french
mes	french
ses	french
ces	french
dans	french
tout	french
sans	french
nous	french
fait	french
tes	french
vous	french
font	french
mais	french
mot	french
sous	french
comme	french
deux	french
notre	french
tous	french
avec	french
vu	french
ils	french
parole	french
elle	french
sont	french
leur	french
encore	french
quel	french
doit	french
hors	french
quand	french
avant	french
peu	french
ici	french
aussi	french
cela	french
trop	french
avoir	french
peut	french
votre	french
depuis	french
autre	french
ceux	french
elles	french
quelle	french
haut	french
fois	french
moins	french
juste	french
essai	french
parce	french
tels	french
alors	french
faites	french
chaque	french
nouveaux	french
seulement	french
où	french
sujet	french
même	french
pourquoi	french
là	french
personnes	french
donc	french
maintenant	french
vont	french
tandis	french
dehors	french
quels	french
voie	french
valeur	french
sien	french
très	french
plupart	french
quelles	french
dedans	french
droite	french
soyez	french
tellement	french
voient	french
pièce	french
devrait	french
aucuns	french
début	french
nommés	french
être	french
été	french
étions	french
état	french
étaient	french
ça	french
im	german
die	german
der	german
den	german
dies	german
da	german
er	german
bis	german
wo	german
von	german
mit	german
und	german
nun	german
ist	german
ja	german
bin	german
das	german
dem	german
aus	german
seine	german
als	german
wer	german
ich	german
sie	german
ein	german
zu	german
aber	german
vor	german
zur	german
oder	german
bei	german
auf	german
sich	german
wie	german
sind	german
auch	german
mein	german
nach	german
nicht	german
hier	german
sein	german
eine	german
vom	german
dort	german
ihr	german
wir	german
zum	german
unter	german
durch	german
einer	german
dein	german
eure	german
dass	german
werden	german
doch	german
ihre	german
wenn	german
einem	german
einen	german
meine	german
wird	german
eines	german
kann	german
bist	german
dieser	german
wann	german
hatte	german
für	german
unser	german
nein	german
dieses	german
soll	german
machen	german
wieder	german
jetzt	german
dessen	german
unsere	german
jeder	german
darum	german
jede	german
daher	german
hinter	german
sollen	german
hatten	german
jener	german
werde	german
weiter	german
warum	german
sonst	german
deine	german
jedes	german
jeden	german
nachdem	german
dadurch	german
jedem	german
sowie	german
weitere	german
können	german
jenes	german
muß	german
wohin	german
deshalb	german
müssen	german
daß	german
woher	german
soweit	german
kannst	german
weshalb	german
über	german
wirst	german
wieso	german
werdet	german
sollt	german
sollst	german
seid	german
müßt	german
mußt	german
musst	german
könnt	german
hattet	german
hattest	german
euer	german
é 	italian
è 	italian
vuole 	italian
vuoi 	italian
volta 	italian
voi 	italian
voglio 	italian
vita 	italian
visto 	italian
vieni 	italian
via 	italian
vi 	italian
vero 	italian
vedere 	italian
vai 	italian
va 	italian
uomo 	italian
uno 	italian
una 	italian
un' 	italian
un 	italian
tutto 	italian
tutti 	italian
tuo 	italian
tua 	italian
tu 	italian
troppo 	italian
tra 	italian
ti 	italian
tempo 	italian
te 	italian
tanto 	italian
sì 	italian
suo 	italian
sul 	italian
sua 	italian
su 	italian
sto 	italian
stato 	italian
stata 	italian
stai 	italian
sta 	italian
sono 	italian
solo 	italian
so 	italian
signore 	italian
signor 	italian
siamo 	italian
sia 	italian
si 	italian
senza 	italian
sempre 	italian
sei 	italian
se 	italian
sarà 	italian
sarebbe 	italian
sai 	italian
sa 	italian
qui 	italian
questo 	italian
questa 	italian
quello 	italian
quella 	italian
quel 	italian
quanto 	italian
quando 	italian
qualcuno 	italian
qualcosa 	italian
può 	italian
puoi 	italian
proprio 	italian
prima 	italian
posto 	italian
posso 	italian
poi 	italian
po' 	italian
più 	italian
perché 	italian
perchè 	italian
per 	italian
parte 	italian
padre 	italian
ora 	italian
oh 	italian
ogni 	italian
o 	italian
non 	italian
noi 	italian
no 	italian
niente 	italian
nessuno 	italian
nella 	italian
nel 	italian
ne 	italian
molto 	italian
mio 	italian
miei 	italian
mia 	italian
mi 	italian
meglio 	italian
me 	italian
male 	italian
mai 	italian
ma 	italian
lui 	italian
loro 	italian
lo 	italian
li 	italian
lei 	italian
le 	italian
lavoro 	italian
la 	italian
l' 	italian
io 	italian
in 	italian
il 	italian
ii 	italian
i' 	italian
i 	italian
ho 	italian
hanno 	italian
hai 	italian
ha 	italian
grazie 	italian
gli 	italian
già 	italian
giorno 	italian
fuori 	italian
forse 	italian
fatto 	italian
fare 	italian
fai 	italian
fa 	italian
essere 	italian
era 	italian
ehi 	italian
ed 	italian
ecco 	italian
e' 	italian
e 	italian
due 	italian
dove 	italian
dopo 	italian
dire 	italian
dio 	italian
dice 	italian
di 	italian
devo 	italian
devi 	italian
deve 	italian
detto 	italian
delle 	italian
della 	italian
dell' 	italian
del 	italian
dei 	italian
davvero 	italian
dalla 	italian
dal 	italian
dai 	italian
da 	italian
d' 	italian
cui 	italian
credo 	italian
così 	italian
cose 	italian
cosa 	italian
cos' 	italian
con 	italian
come 	italian
ciao 	italian
ci 	italian
chi 	italian
che 	italian
certo 	italian
ce 	italian
casa 	italian
c' 	italian
bisogno 	italian
bene 	italian
beh 	italian
avete 	italian
anni 	italian
andiamo 	italian
andare 	italian
ancora 	italian
anche 	italian
amico 	italian
altro 	italian
altra 	italian
allora 	italian
alle 	italian
alla 	italian
all' 	italian
al 	italian
ai 	italian
adesso 	italian
ad 	italian
abbiamo 	italian
a 	italian
per	latin
pro	latin
ex	latin
ad	latin
post	latin
ac	latin
et	latin
sub	latin
inter	latin
non	latin
ne	latin
trans	latin
ab	latin
ut	latin
qui	latin
cum	latin
inde	latin
satis	latin
sed	latin
quod	latin
ante	latin
contra	latin
sine	latin
ita	latin
quam	latin
nam	latin
vel	latin
aut	latin
ego	latin
dum	latin
quis	latin
nunc	latin
atque	latin
unde	latin
nihil	latin
ubi	latin
tum	latin
tam	latin
idem	latin
vos	latin
ille	latin
quia	latin
ipse	latin
etiam	latin
modo	latin
neque	latin
tamen	latin
enim	latin
nec	latin
autem	latin
haud	latin
quidem	latin
deinde	latin
quidam	latin
iste	latin
hic	latin
nondum	latin
quisque	latin
iam	latin
de	spanish
con	spanish
son	spanish
sea	spanish
la	spanish
en	spanish
un	spanish
oh	spanish
al	spanish
le	spanish
si	spanish
sin	spanish
lo	spanish
se	spanish
mis	spanish
ha	spanish
mi	spanish
es	spanish
ser	spanish
te	spanish
hay	spanish
el	spanish
ver	spanish
ti	spanish
les	spanish
era	spanish
ir	spanish
favor	spanish
va	spanish
tu	spanish
del	spanish
nos	spanish
ni	spanish
sus	spanish
que	spanish
su	spanish
para	spanish
tan	spanish
las	spanish
los	spanish
una	spanish
han	spanish
sr	spanish
vas	spanish
dice	spanish
tal	spanish
tus	spanish
solo	spanish
bien	spanish
yo	spanish
gran	spanish
uno	spanish
ya	spanish
como	spanish
dos	spanish
casa	spanish
este	spanish
padre	spanish
esta	spanish
nombre	spanish
mundo	spanish
dios	spanish
soy	spanish
ese	spanish
buena	spanish
crees	spanish
cosa	spanish
gente	spanish
pero	spanish
vida	spanish
poco	spanish
antes	spanish
hasta	spanish
todo	spanish
sobre	spanish
tener	spanish
nuevo	spanish
claro	spanish
bueno	spanish
hombre	spanish
gracias	spanish
amigo	spanish
creo	spanish
hecho	spanish
él	spanish
voy	spanish
vez	spanish
verdad	spanish
vamos	spanish
usted	spanish
tú	spanish
trabajo	spanish
todos	spanish
tipo	spanish
tienes	spanish
tiene	spanish
tiempo	spanish
tengo	spanish
tenemos	spanish
también	spanish
sólo	spanish
sí	spanish
sé	spanish
siento	spanish
siempre	spanish
señor	spanish
será	spanish
seguro	spanish
sabes	spanish
sabe	spanish
qué	spanish
quién	spanish
quiero	spanish
quieres	spanish
quiere	spanish
puedo	spanish
puedes	spanish
puede	spanish
porque	spanish
por	spanish
podría	spanish
podemos	spanish
pasa	spanish
parece	spanish
papá	spanish
otro	spanish
otra	spanish
nunca	spanish
nuestro	spanish
nosotros	spanish
noche	spanish
necesito	spanish
nadie	spanish
mío	spanish
mí	spanish
más	spanish
muy	spanish
mucho	spanish
momento	spanish
mismo	spanish
mierda	spanish
mejor	spanish
mañana	spanish
lugar	spanish
hola	spanish
hijo	spanish
haciendo	spanish
hacer	spanish
hace	spanish
hablar	spanish
gusta	spanish
fuera	spanish
fue	spanish
estás	spanish
están	spanish
está	spanish
estoy	spanish
esto	spanish
estas	spanish
estar	spanish
estamos	spanish
estado	spanish
estaba	spanish
espera	spanish
eso	spanish
esa	spanish
eres	spanish
entonces	spanish
ellos	spanish
dónde	spanish
días	spanish
día	spanish
donde	spanish
dinero	spanish
dijo	spanish
dije	spanish
después	spanish
desde	spanish
decir	spanish
cómo	spanish
cuando	spanish
cosas	spanish
años	spanish
así	spanish
aquí	spanish
alguien	spanish
algo	spanish
ahí	spanish
ahora	spanish
acuerdo	spanish
ii	romannumeral
iii	romannumeral
vi	romannumeral
iv	romannumeral
ix	romannumeral
vii	romannumeral
viii	romannumeral
xi	romannumeral
xii	romannumeral
li	romannumeral
xiv	romannumeral
xv	romannumeral
xiii	romannumeral
xvi	romannumeral
xx	romannumeral
xvii	romannumeral
xviii	romannumeral
xix	romannumeral
xxi	romannumeral
ci	romannumeral
xxii	romannumeral
xxiv	romannumeral
xxiii	romannumeral
xxv	romannumeral
xxvi	romannumeral
xxx	romannumeral
xxvii	romannumeral
xxviii	romannumeral
xxix	romannumeral
xxxi	romannumeral
cl	romannumeral
cc	romannumeral
xxxii	romannumeral
cd	romannumeral
xxxiv	romannumeral
liv	romannumeral
xxxiii	romannumeral
xxxv	romannumeral
xxxvi	romannumeral
xxxvii	romannumeral
xxxix	romannumeral
xxxviii	romannumeral
lii	romannumeral
xli	romannumeral
xlv	romannumeral
xlii	romannumeral
xliv	romannumeral
xliii	romannumeral
xlix	romannumeral
xlvi	romannumeral
lx	romannumeral
xlviii	romannumeral
xlvii	romannumeral
liii	romannumeral
civ	romannumeral
lix	romannumeral
cv	romannumeral
lxx	romannumeral
cii	romannumeral
lvi	romannumeral
lvii	romannumeral
lxi	romannumeral
lviii	romannumeral
lxv	romannumeral
lxvi	romannumeral
lxiii	romannumeral
lxii	romannumeral
lxiv	romannumeral
lxix	romannumeral
lxviii	romannumeral
lxxii	romannumeral
lxvii	romannumeral
xci	romannumeral
lxxi	romannumeral
lxxx	romannumeral
lxxiii	romannumeral
xcv	romannumeral
lxxv	romannumeral
lxxiv	romannumeral
lxxviii	romannumeral
xciv	romannumeral
lxxvii	romannumeral
lxxix	romannumeral
xcii	romannumeral
lxxxix	romannumeral
xcvi	romannumeral
lxxxiv	romannumeral
lxxxi	romannumeral
lxxxv	romannumeral
xcvii	romannumeral
lxxxii	romannumeral
xcix	romannumeral
lxxxvi	romannumeral
lxxxiii	romannumeral
xciii	romannumeral
lxxxvii	romannumeral
xcviii	romannumeral
lxxxviii	romannumeral
clii	romannumeral
cliv	romannumeral
clvi	romannumeral
clix	romannumeral
clvii	romannumeral
clxi	romannumeral
clxii	romannumeral
clxiv	romannumeral
clxvi	romannumeral
clxix	romannumeral
clxvii	romannumeral
xl	romannumeral
xc	romannumeral
lxxvi	romannumeral
lv	romannumeral
cxxxviii	romannumeral
cxxxvii	romannumeral
cxxxvi	romannumeral
cxxxv	romannumeral
cxxxix	romannumeral
cxxxiv	romannumeral
cxxxiii	romannumeral
cxxxii	romannumeral
cxxxi	romannumeral
cxxx	romannumeral
cxxviii	romannumeral
cxxvii	romannumeral
cxxvi	romannumeral
cxxv	romannumeral
cxxix	romannumeral
cxxiv	romannumeral
cxxiii	romannumeral
cxxii	romannumeral
cxxi	romannumeral
cxx	romannumeral
cxviii	romannumeral
cxvii	romannumeral
cxvi	romannumeral
cxv	romannumeral
cxlviii	romannumeral
cxlvii	romannumeral
cxlvi	romannumeral
cxlv	romannumeral
cxlix	romannumeral
cxliv	romannumeral
cxliii	romannumeral
cxlii	romannumeral
cxli	romannumeral
cxl	romannumeral
cxix	romannumeral
cxiv	romannumeral
cxiii	romannumeral
cxii	romannumeral
cxi	romannumeral
cxcviii	romannumeral
cxcvii	romannumeral
cxcvi	romannumeral
cxcv	romannumeral
cxcix	romannumeral
cxciv	romannumeral
cxciii	romannumeral
cxcii	romannumeral
cxci	romannumeral
cxc	romannumeral
cx	romannumeral
cviii	romannumeral
cvii	romannumeral
cvi	romannumeral
clxxxviii	romannumeral
clxxxvii	romannumeral
clxxxvi	romannumeral
clxxxv	romannumeral
clxxxix	romannumeral
clxxxiv	romannumeral
clxxxiii	romannumeral
clxxxii	romannumeral
clxxxi	romannumeral
clxxx	romannumeral
clxxviii	romannumeral
clxxvii	romannumeral
clxxvi	romannumeral
clxxv	romannumeral
clxxix	romannumeral
clxxiv	romannumeral
clxxiii	romannumeral
clxxii	romannumeral
clxxi	romannumeral
clxx	romannumeral
clxviii	romannumeral
clxv	romannumeral
clxiii	romannumeral
clx	romannumeral
clviii	romannumeral
clv	romannumeral
cliii	romannumeral
cli	romannumeral
cix	romannumeral
ciii	romannumeral
cdxxxviii	romannumeral
cdxxxvii	romannumeral
cdxxxvi	romannumeral
cdxxxv	romannumeral
cdxxxix	romannumeral
cdxxxiv	romannumeral
cdxxxiii	romannumeral
cdxxxii	romannumeral
cdxxxi	romannumeral
cdxxx	romannumeral
cdxxviii	romannumeral
cdxxvii	romannumeral
cdxxvi	romannumeral
cdxxv	romannumeral
cdxxix	romannumeral
cdxxiv	romannumeral
cdxxiii	romannumeral
cdxxii	romannumeral
cdxxi	romannumeral
cdxx	romannumeral
cdxviii	romannumeral
cdxvii	romannumeral
cdxvi	romannumeral
cdxv	romannumeral
cdxlviii	romannumeral
cdxlvii	romannumeral
cdxlvi	romannumeral
cdxlv	romannumeral
cdxlix	romannumeral
cdxliv	romannumeral
cdxliii	romannumeral
cdxlii	romannumeral
cdxli	romannumeral
cdxl	romannumeral
cdxix	romannumeral
cdxiv	romannumeral
cdxiii	romannumeral
cdxii	romannumeral
cdxi	romannumeral
cdxcviii	romannumeral
cdxcvii	romannumeral
cdxcvi	romannumeral
cdxcv	romannumeral
cdxcix	romannumeral
cdxciv	romannumeral
cdxciii	romannumeral
cdxcii	romannumeral
cdxci	romannumeral
cdxc	romannumeral
cdx	romannumeral
cdviii	romannumeral
cdvii	romannumeral
cdvi	romannumeral
cdv	romannumeral
cdlxxxviii	romannumeral
cdlxxxvii	romannumeral
cdlxxxvi	romannumeral
cdlxxxv	romannumeral
cdlxxxix	romannumeral
cdlxxxiv	romannumeral
cdlxxxiii	romannumeral
cdlxxxii	romannumeral
cdlxxxi	romannumeral
cdlxxx	romannumeral
cdlxxviii	romannumeral
cdlxxvii	romannumeral
cdlxxvi	romannumeral
cdlxxv	romannumeral
cdlxxix	romannumeral
cdlxxiv	romannumeral
cdlxxiii	romannumeral
cdlxxii	romannumeral
cdlxxi	romannumeral
cdlxx	romannumeral
cdlxviii	romannumeral
cdlxvii	romannumeral
cdlxvi	romannumeral
cdlxv	romannumeral
cdlxix	romannumeral
cdlxiv	romannumeral
cdlxiii	romannumeral
cdlxii	romannumeral
cdlxi	romannumeral
cdlx	romannumeral
cdlviii	romannumeral
cdlvii	romannumeral
cdlvi	romannumeral
cdlv	romannumeral
cdlix	romannumeral
cdliv	romannumeral
cdliii	romannumeral
cdlii	romannumeral
cdli	romannumeral
cdl	romannumeral
cdix	romannumeral
cdiv	romannumeral
cdiii	romannumeral
cdii	romannumeral
cdi	romannumeral
ccxxxviii	romannumeral
ccxxxvii	romannumeral
ccxxxvi	romannumeral
ccxxxv	romannumeral
ccxxxix	romannumeral
ccxxxiv	romannumeral
ccxxxiii	romannumeral
ccxxxii	romannumeral
ccxxxi	romannumeral
ccxxx	romannumeral
ccxxviii	romannumeral
ccxxvii	romannumeral
ccxxvi	romannumeral
ccxxv	romannumeral
ccxxix	romannumeral
ccxxiv	romannumeral
ccxxiii	romannumeral
ccxxii	romannumeral
ccxxi	romannumeral
ccxx	romannumeral
ccxviii	romannumeral
ccxvii	romannumeral
ccxvi	romannumeral
ccxv	romannumeral
ccxlviii	romannumeral
ccxlvii	romannumeral
ccxlvi	romannumeral
ccxlv	romannumeral
ccxlix	romannumeral
ccxliv	romannumeral
ccxliii	romannumeral
ccxlii	romannumeral
ccxli	romannumeral
ccxl	romannumeral
ccxix	romannumeral
ccxiv	romannumeral
ccxiii	romannumeral
ccxii	romannumeral
ccxi	romannumeral
ccxcviii	romannumeral
ccxcvii	romannumeral
ccxcvi	romannumeral
ccxcv	romannumeral
ccxcix	romannumeral
ccxciv	romannumeral
ccxciii	romannumeral
ccxcii	romannumeral
ccxci	romannumeral
ccxc	romannumeral
ccx	romannumeral
ccviii	romannumeral
ccvii	romannumeral
ccvi	romannumeral
ccv	romannumeral
cclxxxviii	romannumeral
cclxxxvii	romannumeral
cclxxxvi	romannumeral
cclxxxv	romannumeral
cclxxxix	romannumeral
cclxxxiv	romannumeral
cclxxxiii	romannumeral
cclxxxii	romannumeral
cclxxxi	romannumeral
cclxxx	romannumeral
cclxxviii	romannumeral
cclxxvii	romannumeral
cclxxvi	romannumeral
cclxxv	romannumeral
cclxxix	romannumeral
cclxxiv	romannumeral
cclxxiii	romannumeral
cclxxii	romannumeral
cclxxi	romannumeral
cclxx	romannumeral
cclxviii	romannumeral
cclxvii	romannumeral
cclxvi	romannumeral
cclxv	romannumeral
cclxix	romannumeral
cclxiv	romannumeral
cclxiii	romannumeral
cclxii	romannumeral
cclxi	romannumeral
cclx	romannumeral
cclviii	romannumeral
cclvii	romannumeral
cclvi	romannumeral
cclv	romannumeral
cclix	romannumeral
ccliv	romannumeral
ccliii	romannumeral
cclii	romannumeral
ccli	romannumeral
ccl	romannumeral
ccix	romannumeral
cciv	romannumeral
cciii	romannumeral
ccii	romannumeral
cci	romannumeral
cccxxxviii	romannumeral
cccxxxvii	romannumeral
cccxxxvi	romannumeral
cccxxxv	romannumeral
cccxxxix	romannumeral
cccxxxiv	romannumeral
cccxxxiii	romannumeral
cccxxxii	romannumeral
cccxxxi	romannumeral
cccxxx	romannumeral
cccxxviii	romannumeral
cccxxvii	romannumeral
cccxxvi	romannumeral
cccxxv	romannumeral
cccxxix	romannumeral
cccxxiv	romannumeral
cccxxiii	romannumeral
cccxxii	romannumeral
cccxxi	romannumeral
cccxx	romannumeral
cccxviii	romannumeral
cccxvii	romannumeral
cccxvi	romannumeral
cccxv	romannumeral
cccxlviii	romannumeral
cccxlvii	romannumeral
cccxlvi	romannumeral
cccxlv	romannumeral
cccxlix	romannumeral
cccxliv	romannumeral
cccxliii	romannumeral
cccxlii	romannumeral
cccxli	romannumeral
cccxl	romannumeral
cccxix	romannumeral
cccxiv	romannumeral
cccxiii	romannumeral
cccxii	romannumeral
cccxi	romannumeral
cccxcviii	romannumeral
cccxcvii	romannumeral
cccxcvi	romannumeral
cccxcv	romannumeral
cccxcix	romannumeral
cccxciv	romannumeral
cccxciii	romannumeral
cccxcii	romannumeral
cccxci	romannumeral
cccxc	romannumeral
cccx	romannumeral
cccviii	romannumeral
cccvii	romannumeral
cccvi	romannumeral
cccv	romannumeral
ccclxxxviii	romannumeral
ccclxxxvii	romannumeral
ccclxxxvi	romannumeral
ccclxxxv	romannumeral
ccclxxxix	romannumeral
ccclxxxiv	romannumeral
ccclxxxiii	romannumeral
ccclxxxii	romannumeral
ccclxxxi	romannumeral
ccclxxx	romannumeral
ccclxxviii	romannumeral
ccclxxvii	romannumeral
ccclxxvi	romannumeral
ccclxxv	romannumeral
ccclxxix	romannumeral
ccclxxiv	romannumeral
ccclxxiii	romannumeral
ccclxxii	romannumeral
ccclxxi	romannumeral
ccclxx	romannumeral
ccclxviii	romannumeral
ccclxvii	romannumeral
ccclxvi	romannumeral
ccclxv	romannumeral
ccclxix	romannumeral
ccclxiv	romannumeral
ccclxiii	romannumeral
ccclxii	romannumeral
ccclxi	romannumeral
ccclx	romannumeral
ccclviii	romannumeral
ccclvii	romannumeral
ccclvi	romannumeral
ccclv	romannumeral
ccclix	romannumeral
cccliv	romannumeral
cccliii	romannumeral
ccclii	romannumeral
cccli	romannumeral
cccl	romannumeral
cccix	romannumeral
ccciv	romannumeral
ccciii	romannumeral
cccii	romannumeral
ccci	romannumeral
ccc	romannumeral
john	name
william	name
james	name
charles	name
george	name
henry	name
thomas	name
mary	name
robert	name
edward	name
van	name
joseph	name
frank	name
peter	name
david	name
richard	name
paul	name
alexander	name
samuel	name
francis	name
louis	name
philip	name
tom	name
rob	name
jo	name
lee	name
martin	name
adam	name
daniel	name
elizabeth	name
johnson	name
walter	name
scott	name
taylor	name
andrew	name
arthur	name
moses	name
jacob	name
jack	name
wm	name
wilson	name
isaac	name
dan	name
frederick	name
stephen	name
lewis	name
michael	name
foster	name
abraham	name
williams	name
jan	name
horace	name
chris	name
benjamin	name
ann	name
matthew	name
maria	name
chester	name
anne	name
milton	name
solomon	name
homer	name
simon	name
oliver	name
nicholas	name
lawrence	name
franklin	name
lincoln	name
napoleon	name
sam	name
alfred	name
newton	name
jackson	name
hugh	name
allen	name
brooks	name
augustus	name
walker	name
tim	name
stuart	name
albert	name
howard	name
edmund	name
anthony	name
julius	name
murray	name
jane	name
russell	name
warren	name
clark	name
val	name
margaret	name
luke	name
harry	name
davis	name
anna	name
herbert	name
norman	name
gilbert	name
joshua	name
clement	name
buck	name
parker	name
spencer	name
alex	name
patrick	name
morris	name
arnold	name
roger	name
stewart	name
victoria	name
bernard	name
virgil	name
gregory	name
marshall	name
douglas	name
christopher	name
gordon	name
owen	name
harris	name
phil	name
jonathan	name
jean	name
luther	name
morgan	name
harrison	name
roy	name
sally	name
robin	name
sarah	name
marie	name
mac	name
clare	name
nelson	name
byron	name
ross	name
leo	name
anderson	name
catherine	name
theodore	name
sidney	name
columbus	name
palmer	name
stanley	name
ralph	name
ellis	name
charlotte	name
wade	name
augustine	name
eliza	name
santa	name
graham	name
felix	name
leon	name
howe	name
timothy	name
diana	name
titus	name
burton	name
jay	name
jefferson	name
isaiah	name
vincent	name
pierre	name
milan	name
edwin	name
helen	name
dick	name
jeremiah	name
max	name
ferdinand	name
noah	name
aaron	name
wallace	name
cornelius	name
chi	name
ali	name
carter	name
cole	name
hal	name
bruce	name
vera	name
fletcher	name
nathaniel	name
harvey	name
gabriel	name
julian	name
bailey	name
morton	name
monte	name
maurice	name
mitchell	name
jerome	name
caroline	name
guy	name
percy	name
matt	name
marcus	name
duncan	name
fran	name
saul	name
fred	name
frederic	name
perry	name
ruth	name
helena	name
dudley	name
abel	name
theo	name
ira	name
dante	name
sydney	name
dee	name
calvin	name
leonard	name
christi	name
alice	name
lloyd	name
lucy	name
antonio	name
preston	name
cyrus	name
isabella	name
martha	name
vernon	name
josiah	name
ord	name
bob	name
clinton	name
leigh	name
stan	name
benedict	name
julia	name
blake	name
hector	name
elijah	name
levi	name
joan	name
nathan	name
juan	name
eugene	name
rosa	name
chas	name
edgar	name
irving	name
madison	name
randolph	name
amos	name
augusta	name
bradford	name
basil	name
minerva	name
frances	name
barton	name
elias	name
mel	name
otto	name
kit	name
crawford	name
walton	name
angelo	name
hannah	name
eli	name
agnes	name
ned	name
barry	name
willis	name
ambrose	name
lucas	name
rufus	name
jasper	name
carl	name
ulysses	name
raphael	name
allan	name
gil	name
seymour	name
curtis	name
raleigh	name
mansfield	name
blair	name
sheridan	name
sophia	name
brooke	name
asa	name
nick	name
clara	name
bella	name
reid	name
devon	name
ezekiel	name
hugo	name
leslie	name
beaumont	name
joe	name
monroe	name
hans	name
sebastian	name
antony	name
wesley	name
ernest	name
tyler	name
emerson	name
bennett	name
catharine	name
maxwell	name
warner	name
louisa	name
gerard	name
jesse	name
harold	name
kate	name
valentine	name
adrian	name
magdalen	name
justin	name
ida	name
elliot	name
donald	name
sherman	name
lowell	name
raymond	name
susan	name
joel	name
mackenzie	name
ellen	name
laurence	name
dennis	name
kelly	name
lucius	name
elliott	name
harriet	name
clifford	name
lydia	name
carey	name
claude	name
cecil	name
clarence	name
tanner	name
rachel	name
quincy	name
emma	name
esther	name
blanche	name
barbara	name
cameron	name
lorenzo	name
jim	name
constance	name
jacques	name
fanny	name
nancy	name
darwin	name
bradley	name
marion	name
ezra	name
rey	name
bryant	name
enoch	name
jeremy	name
elisha	name
linn	name
svo	name
caleb	name
craig	name
clair	name
silas	name
boyd	name
cleopatra	name
donna	name
lynn	name
eddy	name
jonas	name
norris	name
keith	name
seth	name
todd	name
nell	name
dana	name
evan	name
domingo	name
denis	name
everett	name
malcolm	name
henrietta	name
granville	name
pedro	name
karl	name
sara	name
weston	name
herman	name
isis	name
nicolas	name
manuel	name
ada	name
shelley	name
verona	name
logan	name
clifton	name
darius	name
lindsay	name
amelia	name
laura	name
lorraine	name
eleanor	name
jenny	name
tod	name
emily	name
conrad	name
cruz	name
clyde	name
jon	name
judith	name
bryan	name
matilda	name
roland	name
barrett	name
michel	name
hubert	name
melville	name
jonah	name
marc	name
andre	name
shirley	name
emanuel	name
whitney	name
rebecca	name
roma	name
lou	name
dona	name
otis	name
kay	name
louise	name
ashley	name
dexter	name
eccles	name
coleman	name
isabel	name
carroll	name
bartlett	name
carlos	name
dalton	name
madonna	name
wayne	name
clayton	name
evelyn	name
reuben	name
amy	name
stanton	name
christen	name
annie	name
bethel	name
lyman	name
hiram	name
sabine	name
sylvester	name
earle	name
flo	name
mack	name
glover	name
trenton	name
terence	name
jose	name
beatrice	name
ava	name
sheldon	name
orlando	name
marco	name
tracy	name
billy	name
juliet	name
maud	name
gary	name
reginald	name
leland	name
geoffrey	name
carlo	name
emery	name
adelaide	name
betty	name
wilton	name
ella	name
curt	name
carmen	name
mohammed	name
santo	name
stella	name
cary	name
colin	name
eva	name
kirby	name
jason	name
jude	name
noel	name
marian	name
diego	name
joanna	name
randall	name
meredith	name
giovanni	name
theresa	name
lacy	name
christiana	name
dwight	name
dorothy	name
romeo	name
carlton	name
willard	name
benton	name
oscar	name
harley	name
shannon	name
brad	name
delia	name
cora	name
marcellus	name
galen	name
cecilia	name
rupert	name
antoine	name
jeffrey	name
lois	name
forrest	name
dora	name
gertrude	name
abram	name
doyle	name
sena	name
johnny	name
luc	name
terry	name
polly	name
merlin	name
mira	name
magdalene	name
rochelle	name
milford	name
avery	name
jena	name
lucia	name
alton	name
jules	name
alonzo	name
eric	name
douglass	name
christina	name
mina	name
deane	name
riley	name
willie	name
wei	name
neal	name
wendell	name
ashton	name
russel	name
dion	name
emmanuel	name
kim	name
hosea	name
kendall	name
josephine	name
wyatt	name
milo	name
rene	name
lilly	name
penelope	name
brent	name
sharon	name
gerald	name
brandon	name
lionel	name
mathew	name
brady	name
edith	name
alexis	name
barb	name
floyd	name
cyril	name
bridget	name
viola	name
brock	name
leone	name
brian	name
neville	name
henley	name
katharine	name
andrea	name
fernando	name
nestor	name
katherine	name
dillon	name
reeves	name
luis	name
susanna	name
alan	name
sibyl	name
christie	name
deborah	name
gus	name
pauline	name
alva	name
cornell	name
maynard	name
lucretia	name
palma	name
hilton	name
garth	name
waldo	name
pam	name
abigail	name
rodney	name
bess	name
valencia	name
toby	name
antoinette	name
mona	name
daphne	name
anton	name
kara	name
ryan	name
roscoe	name
herschel	name
guilford	name
cornelia	name
omar	name
aubrey	name
rico	name
damon	name
angelica	name
tony	name
molly	name
jarvis	name
micah	name
zachary	name
phillip	name
carmel	name
neil	name
beverly	name
arden	name
hilary	name
garrett	name
hester	name
leonardo	name
darby	name
burt	name
sanford	name
lena	name
mara	name
kitty	name
xavier	name
andreas	name
bertram	name
merrill	name
blanch	name
cynthia	name
bruno	name
beverley	name
rudolph	name
vesta	name
erin	name
francesco	name
miranda	name
meg	name
gaston	name
dakota	name
motte	name
irwin	name
marguerite	name
sheba	name
josh	name
bertha	name
marina	name
tommy	name
alison	name
alden	name
janet	name
barney	name
kendal	name
carson	name
chauncey	name
ariel	name
miguel	name
beauchamp	name
charlie	name
shiloh	name
dominic	name
phoebe	name
olympia	name
irene	name
charley	name
hong	name
kerry	name
emile	name
starr	name
romana	name
dominica	name
dorothea	name
denver	name
greville	name
nora	name
santiago	name
werner	name
miriam	name
lemuel	name
thaddeus	name
ellsworth	name
salvador	name
jong	name
oneida	name
judson	name
denny	name
joyce	name
eldon	name
greg	name
lester	name
bethany	name
hanna	name
jess	name
wiley	name
marietta	name
jared	name
pete	name
omer	name
ivan	name
dolly	name
ursula	name
cassandra	name
dewey	name
jill	name
garfield	name
jerry	name
allison	name
brant	name
genevieve	name
mariana	name
leroy	name
shan	name
jessie	name
chang	name
jewell	name
jeanne	name
priscilla	name
kelley	name
silva	name
hoyt	name
neva	name
selby	name
cortez	name
jervis	name
gregg	name
clarissa	name
vivian	name
blythe	name
jed	name
marcy	name
vern	name
adolph	name
lucien	name
lindsey	name
ethel	name
brett	name
peggy	name
courtney	name
mabel	name
lovelace	name
carrie	name
garnett	name
sybil	name
mae	name
tyrone	name
bernardo	name
alfonso	name
kenneth	name
nicol	name
hassan	name
alexandra	name
steven	name
tara	name
chad	name
hayden	name
chloe	name
alphonse	name
trevor	name
zachariah	name
millard	name
juliana	name
margery	name
mike	name
fritz	name
nelly	name
petra	name
deb	name
sylvia	name
dorcas	name
dewitt	name
fabian	name
celia	name
grover	name
ethan	name
russ	name
maire	name
rhea	name
lizzie	name
elisabeth	name
camilla	name
elia	name
shelby	name
sophie	name
betsy	name
jeff	name
claud	name
elton	name
romaine	name
marvin	name
leah	name
patty	name
minnie	name
johanna	name
chadwick	name
leonora	name
ricardo	name
shelton	name
rosamond	name
sabina	name
laurie	name
bessie	name
emory	name
casey	name
teresa	name
skye	name
weldon	name
portia	name
ophelia	name
gerry	name
doug	name
maggie	name
boyce	name
maude	name
bryce	name
hotspur	name
emil	name
willy	name
nina	name
duane	name
elmer	name
wilbur	name
halley	name
jennie	name
lyle	name
glaucus	name
julio	name
lara	name
claire	name
doris	name
felice	name
veronica	name
marcel	name
merle	name
doria	name
hickman	name
marin	name
mario	name
betsey	name
agatha	name
nellie	name
thalia	name
christy	name
daniell	name
donovan	name
rodrigo	name
kip	name
octavia	name
harlan	name
blaine	name
candida	name
winston	name
dorian	name
theodora	name
kenny	name
madeleine	name
tamar	name
bertie	name
carman	name
leda	name
shea	name
derrick	name
haywood	name
odessa	name
tula	name
letitia	name
olivia	name
mallory	name
macy	name
kyle	name
paz	name
dinah	name
myra	name
norma	name
amanda	name
shu	name
angela	name
myron	name
colby	name
aline	name
camille	name
elmira	name
julie	name
pandora	name
truman	name
phebe	name
bari	name
desmond	name
grandison	name
margarita	name
gavin	name
ronald	name
abby	name
lucina	name
mao	name
dolores	name
zenobia	name
eugenia	name
eunice	name
rosetta	name
rosalind	name
jamie	name
mildred	name
moira	name
tristan	name
archie	name
serena	name
rhoda	name
brice	name
tyson	name
gail	name
valentin	name
mckenzie	name
andy	name
roosevelt	name
christine	name
judy	name
claudia	name
joaquin	name
nola	name
phyllis	name
celeste	name
travis	name
darcy	name
nathanael	name
marianne	name
erwin	name
glenn	name
magdalena	name
sari	name
elvira	name
marg	name
tiffany	name
gemma	name
andres	name
jake	name
lamar	name
giuseppe	name
naomi	name
elsie	name
aspasia	name
adeline	name
rudolf	name
felicia	name
winifred	name
rana	name
pamela	name
nolan	name
melvin	name
kelsey	name
libby	name
oliva	name
melissa	name
alvin	name
edda	name
marcia	name
veda	name
whitley	name
francesca	name
mckinley	name
hellen	name
santos	name
wilfred	name
paula	name
roberto	name
katie	name
orville	name
marx	name
delilah	name
linda	name
ismael	name
dixie	name
dominique	name
cinderella	name
belinda	name
maia	name
booker	name
salina	name
hargrave	name
geraldine	name
claudio	name
alicia	name
dave	name
hortense	name
quinn	name
edna	name
edison	name
stacy	name
dacia	name
lori	name
gaylord	name
shay	name
lulu	name
emmett	name
irvin	name
dominick	name
monica	name
rafael	name
selma	name
cicely	name
clementine	name
gwyn	name
erica	name
corey	name
beulah	name
elaine	name
lacey	name
maya	name
iona	name
germaine	name
alberto	name
diane	name
olin	name
johnnie	name
haley	name
evangeline	name
lilian	name
fonda	name
chara	name
madeline	name
jeanie	name
pablo	name
brande	name
elwood	name
kenton	name
elinor	name
garry	name
ramon	name
annette	name
elbert	name
jimmy	name
renard	name
rosalie	name
guadalupe	name
angelina	name
vaughn	name
carrol	name
josef	name
hattie	name
helene	name
lisa	name
aubert	name
shawnee	name
adele	name
branden	name
clementina	name
sheri	name
krishna	name
frederica	name
bobby	name
johanne	name
wilhelmina	name
burma	name
bree	name
cheyenne	name
stephan	name
jeannette	name
lyndon	name
camellia	name
michele	name
minna	name
luci	name
rosario	name
joanne	name
isabelle	name
bette	name
nicola	name
mignon	name
kami	name
errol	name
corrie	name
juli	name
catalina	name
liz	name
clemente	name
lillian	name
rolf	name
gabrielle	name
susie	name
marty	name
zoe	name
anastasia	name
yorick	name
fatima	name
marcos	name
nicole	name
kathleen	name
noma	name
loren	name
francoise	name
oren	name
mattie	name
tatum	name
mitch	name
argentina	name
olga	name
effie	name
leila	name
zola	name
larry	name
lola	name
melita	name
grady	name
royce	name
allyn	name
thurman	name
jacqueline	name
althea	name
sabrina	name
greta	name
patrice	name
barrie	name
patti	name
lissa	name
aron	name
elena	name
hilde	name
fidelia	name
jorge	name
xenia	name
penni	name
melinda	name
nannie	name
roberta	name
lottie	name
boris	name
vito	name
allie	name
internet	name
kimberley	name
hillary	name
elise	name
normand	name
rena	name
leif	name
martine	name
vanessa	name
rowena	name
mercedes	name
concepcion	name
candace	name
mimi	name
dione	name
lauren	name
marjorie	name
emilio	name
jessica	name
gretchen	name
yang	name
samara	name
audrey	name
marjory	name
shasta	name
alec	name
becky	name
gracie	name
mamie	name
keenan	name
britany	name
woodrow	name
ferne	name
artie	name
mollie	name
vashti	name
selene	name
muriel	name
mila	name
rubi	name
salvatore	name
pinkie	name
jasmin	name
delphine	name
leona	name
missy	name
bernice	name
violette	name
eddie	name
sammy	name
lenore	name
kelvin	name
sadie	name
millie	name
erich	name
valery	name
lourdes	name
ronda	name
cody	name
sofia	name
estella	name
ruben	name
martina	name
cami	name
angeline	name
bunny	name
enid	name
anita	name
colleen	name
cecily	name
kari	name
lila	name
thora	name
arica	name
erik	name
darrell	name
eloise	name
justine	name
ernestine	name
kina	name
valerie	name
berna	name
reagan	name
kurt	name
patricia	name
bibi	name
gladys	name
tanna	name
alberta	name
rubin	name
rosie	name
gwen	name
devin	name
laure	name
lorette	name
renee	name
lura	name
teddy	name
norbert	name
adelia	name
ervin	name
chung	name
kimberly	name
cassi	name
marlin	name
benny	name
clint	name
lorna	name
sandra	name
karen	name
winnie	name
dustin	name
hortensia	name
jacque	name
jeanette	name
steve	name
rolando	name
marline	name
damien	name
bernardine	name
mervin	name
pilar	name
stephanie	name
tuan	name
jana	name
hyman	name
modesto	name
suzanne	name
margot	name
kandy	name
willa	name
jeannie	name
penney	name
annabel	name
christiane	name
kevin	name
fredrick	name
monty	name
perla	name
lucille	name
luella	name
katharina	name
gustavo	name
randy	name
sheila	name
buster	name
gino	name
luise	name
melania	name
joey	name
gabriele	name
delicia	name
albertine	name
torri	name
lisette	name
margarite	name
mohamed	name
margarete	name
eduardo	name
hertha	name
ayesha	name
ashanti	name
sherrill	name
tammy	name
olinda	name
julienne	name
freddy	name
susanne	name
delmar	name
adrienne	name
veta	name
sabra	name
vella	name
tillie	name
robbie	name
herma	name
jinny	name
loretta	name
magen	name
janina	name
jaime	name
huey	name
vanda	name
asuncion	name
raul	name
laci	name
natalie	name
patsy	name
keren	name
mickey	name
dario	name
celestina	name
irma	name
cedric	name
brendan	name
aida	name
francie	name
robbin	name
wally	name
chanel	name
ellie	name
emmy	name
roxy	name
camelia	name
gudrun	name
freddie	name
courteney	name
bryon	name
gilda	name
saran	name
pattie	name
juanita	name
carole	name
brandi	name
hettie	name
marsha	name
rudy	name
rickey	name
alexia	name
alfredo	name
gisela	name
frankie	name
arturo	name
talitha	name
rosella	name
ramona	name
sunni	name
katrina	name
angie	name
emerita	name
danny	name
freda	name
ernie	name
candie	name
janie	name
melanie	name
lorelei	name
allegra	name
helga	name
ilse	name
janis	name
stefan	name
brenda	name
tisa	name
carolyn	name
hermine	name
jimmie	name
elroy	name
donny	name
cristi	name
hildegard	name
connie	name
aileen	name
karri	name
dotty	name
eileen	name
colette	name
palmira	name
debby	name
thelma	name
erna	name
buddy	name
ranae	name
markus	name
collette	name
sylvie	name
vivaldi	name
mauricio	name
carla	name
christa	name
solange	name
brigid	name
ingeborg	name
lorinda	name
nanette	name
jutta	name
bobbie	name
ariane	name
shari	name
selena	name
kenia	name
carlota	name
lenny	name
michelle	name
kamala	name
daron	name
janice	name
gerda	name
indira	name
yuri	name
marceline	name
wendy	name
judie	name
suzette	name
ronnie	name
georgette	name
edwina	name
melba	name
karin	name
kasha	name
jackie	name
debra	name
carissa	name
barbera	name
wilma	name
santana	name
heidi	name
elvis	name
brigitte	name
paulette	name
nadine	name
tessie	name
gertrud	name
doreen	name
deirdre	name
marissa	name
ligia	name
karol	name
daryl	name
bernadette	name
luba	name
vernie	name
lindy	name
bernie	name
scotty	name
celesta	name
francine	name
maurine	name
maxine	name
kermit	name
renée	name
giselle	name
yvette	name
erika	name
derek	name
renate	name
debbie	name
anabel	name
mickie	name
valda	name
christel	name
cathy	name
tommie	name
glenda	name
jody	name
carmela	name
irina	name
kenya	name
arlene	name
jennifer	name
bernadine	name
scottie	name
marilyn	name
marcie	name
conchita	name
arlen	name
clarine	name
marlo	name
golda	name
ilona	name
maureen	name
verdie	name
timmy	name
noreen	name
trudy	name
cindy	name
vicky	name
larisa	name
tressa	name
tanya	name
ulrike	name
nadia	name
marlene	name
hershel	name
shona	name
ingrid	name
angelika	name
deneen	name
rozella	name
aisha	name
heike	name
dylan	name
birgit	name
rhonda	name
lavette	name
kristin	name
kristina	name
lexie	name
dianne	name
linette	name
rosalyn	name
micheline	name
ossie	name
monika	name
stevie	name
shayne	name
vickie	name
darlene	name
kizzie	name
tijuana	name
freida	name
irmgard	name
kathy	name
berniece	name
kylie	name
elfriede	name
carisa	name
cheryl	name
karmen	name
daphine	name
svetlana	name
deanna	name
tonette	name
diedre	name
anneliese	name
kenyatta	name
alyssa	name
hannelore	name
zulma	name
zulema	name
zula	name
zoraida	name
zora	name
zonia	name
zoila	name
zofia	name
zita	name
zina	name
zetta	name
zenia	name
zenaida	name
zena	name
zelma	name
zella	name
zelda	name
zane	name
zandra	name
zana	name
zaida	name
zada	name
zackary	name
zack	name
zachery	name
yvonne	name
yvone	name
yuriko	name
yuonne	name
yung	name
yun	name
yulanda	name
yuko	name
yukiko	name
yuki	name
yuette	name
youlanda	name
yoshiko	name
yoshie	name
yolonda	name
yolando	name
yolande	name
yolanda	name
yoko	name
ying	name
yi	name
yevette	name
yetta	name
yessenia	name
yesenia	name
yelena	name
yasuko	name
yasmine	name
yasmin	name
yanira	name
yan	name
yajaira	name
yahaira	name
yael	name
yaeko	name
yadira	name
xuan	name
xochitl	name
xiomara	name
xiao	name
wynona	name
wynell	name
wonda	name
winona	name
winnifred	name
winfred	name
winford	name
wilmer	name
willodean	name
williemae	name
willian	name
willia	name
willette	name
willetta	name
willene	name
willena	name
wilhemina	name
wilfredo	name
wilford	name
wilda	name
wilburn	name
wilbert	name
wilber	name
wes	name
wenona	name
wendolyn	name
wendie	name
wendi	name
waylon	name
wava	name
wanita	name
wanetta	name
waneta	name
wanda	name
waltraud	name
wai	name
vonnie	name
vonda	name
voncile	name
vivienne	name
vivien	name
viviana	name
vivan	name
virgina	name
virgilio	name
virgie	name
virgen	name
violeta	name
vinnie	name
vinita	name
vincenzo	name
vincenza	name
vilma	name
vikki	name
viki	name
victorina	name
vicki	name
vickey	name
vicente	name
vicenta	name
vertie	name
veronique	name
veronika	name
vernita	name
vernice	name
vernia	name
vernetta	name
vernell	name
verline	name
verlie	name
verlene	name
verla	name
vergie	name
verena	name
verdell	name
verda	name
veola	name
vennie	name
venita	name
venetta	name
venessa	name
velva	name
velma	name
velia	name
velda	name
ve	name
vasiliki	name
vannessa	name
vannesa	name
vanita	name
vania	name
vanetta	name
vanesa	name
valrie	name
valorie	name
vallie	name
valeria	name
valeri	name
valentina	name
valene	name
valarie	name
vada	name
usha	name
ula	name
tyron	name
tyrell	name
tyree	name
tyra	name
tynisha	name
tyisha	name
tyesha	name
ty	name
twyla	name
twila	name
twanna	name
twanda	name
twana	name
tuyet	name
trula	name
trudie	name
trudi	name
trista	name
trisha	name
trish	name
trinh	name
tricia	name
treva	name
tressie	name
tresa	name
trena	name
treena	name
treasa	name
trang	name
tran	name
tracie	name
traci	name
tracey	name
tracee	name
toya	name
towanda	name
tova	name
toshiko	name
toshia	name
tosha	name
torrie	name
torie	name
tora	name
tonya	name
tonja	name
tonita	name
tonisha	name
tonie	name
tonia	name
toney	name
tonda	name
tona	name
tomoko	name
tommye	name
tomiko	name
tomika	name
tomi	name
tomeka	name
tomasa	name
tomas	name
toccara	name
tobie	name
tobias	name
tobi	name
tisha	name
tish	name
tinisha	name
timika	name
tilda	name
tiffiny	name
tiffanie	name
tiffani	name
tiffaney	name
tifany	name
tiesha	name
tiera	name
tianna	name
tiana	name
thuy	name
thresa	name
thomasine	name
thomasina	name
thomasena	name
thersa	name
theron	name
theressa	name
theresia	name
therese	name
therere	name
theola	name
theda	name
thao	name
thanh	name
thad	name
tessa	name
tesha	name
terrilyn	name
terrie	name
terri	name
terresa	name
terrence	name
terrell	name
terrance	name
terisa	name
terina	name
terica	name
teri	name
teressa	name
teresita	name
teresia	name
terese	name
tereasa	name
teofila	name
teodoro	name
teodora	name
tennille	name
tennie	name
tenisha	name
tenesha	name
tempie	name
temika	name
temeka	name
telma	name
teisha	name
tegan	name
teena	name
tayna	name
tawnya	name
tawna	name
tawanna	name
tawanda	name
tawana	name
taunya	name
tatyana	name
tatiana	name
tasia	name
tashina	name
tashia	name
tasha	name
taryn	name
tarsha	name
tarra	name
taren	name
tarah	name
tanja	name
tanisha	name
tanika	name
tania	name
tangela	name
tanesha	name
taneka	name
tandy	name
tandra	name
tamra	name
tammie	name
tammi	name
tammera	name
tammara	name
tamisha	name
tamiko	name
tamika	name
tamie	name
tamica	name
tami	name
tamesha	name
tamera	name
tamela	name
tamekia	name
tameka	name
tameika	name
tambra	name
tamatha	name
tamara	name
tamala	name
tama	name
talisha	name
talia	name
takisha	name
takako	name
tajuana	name
taisha	name
taina	name
tabitha	name
tabetha	name
tabatha	name
syreeta	name
synthia	name
syble	name
suzy	name
suzie	name
suzi	name
suzanna	name
suzann	name
suzan	name
susy	name
susannah	name
susann	name
susana	name
sumiko	name
sulema	name
suk	name
suellen	name
sueann	name
sudie	name
suanne	name
stephnie	name
stephine	name
stephenie	name
stephany	name
stephania	name
stephani	name
stephane	name
stephaine	name
stepanie	name
steffanie	name
stefany	name
stefanie	name
stefania	name
stefani	name
stasia	name
starla	name
stacie	name
stacia	name
staci	name
stacey	name
stacee	name
soraya	name
sonya	name
sonja	name
sonia	name
sondra	name
sona	name
somer	name
soledad	name
soila	name
socorro	name
slyvia	name
sixta	name
siu	name
sirena	name
siobhan	name
sindy	name
sina	name
simonne	name
simone	name
simona	name
silvia	name
silvana	name
sigrid	name
shyla	name
shoshana	name
shonta	name
shonna	name
shondra	name
shonda	name
shon	name
shizuko	name
shizue	name
shirly	name
shirlene	name
shirleen	name
shirlee	name
shirl	name
shirely	name
shira	name
shila	name
shiela	name
sheryll	name
sheryl	name
shery	name
sherryl	name
sherron	name
sherril	name
sherrie	name
sherri	name
sherrell	name
sheron	name
sherlyn	name
sherly	name
sherley	name
sherlene	name
sherita	name
sherise	name
sherilyn	name
sherill	name
sherika	name
sherie	name
sherice	name
sherell	name
sheree	name
shera	name
shenna	name
shenita	name
shenika	name
shena	name
shemika	name
shemeka	name
shellie	name
shelli	name
shella	name
shelia	name
shelba	name
shela	name
sheilah	name
sheena	name
shayna	name
shayla	name
shawnta	name
shawnna	name
shawnda	name
shawna	name
shawn	name
shawanna	name
shawanda	name
shawana	name
shavonne	name
shavonda	name
shavon	name
shaunte	name
shaunta	name
shaunna	name
shaunda	name
shauna	name
shaun	name
sharyn	name
sharyl	name
sharron	name
sharri	name
sharonda	name
sharolyn	name
sharmaine	name
sharlene	name
sharleen	name
sharla	name
sharita	name
sharilyn	name
sharika	name
sharie	name
sharice	name
sharen	name
sharell	name
sharee	name
sharda	name
sharan	name
shara	name
shaquita	name
shaquana	name
shanti	name
shantelle	name
shantell	name
shantel	name
shante	name
shantay	name
shantae	name
shanta	name
shanon	name
shannan	name
shanna	name
shanita	name
shaniqua	name
shanika	name
shanice	name
shani	name
shanelle	name
shanell	name
shanel	name
shaneka	name
shane	name
shandra	name
shandi	name
shanda	name
shanae	name
shana	name
shamika	name
shameka	name
shalonda	name
shalon	name
shalanda	name
shala	name
shakita	name
shakira	name
shakia	name
shaina	name
shae	name
sha	name
seyton	name
setsuko	name
serita	name
serina	name
sergio	name
serafina	name
senaida	name
selina	name
seema	name
sebrina	name
scarlett	name
saundra	name
sau	name
saturnina	name
sasha	name
sarita	name
sarina	name
sarai	name
santina	name
sanora	name
sanjuanita	name
sanjuana	name
sandie	name
sandi	name
sandee	name
sanda	name
samual	name
sammie	name
samira	name
samella	name
samatha	name
samantha	name
salome	name
sallie	name
salley	name
salena	name
sadye	name
sachiko	name
sacha	name
ryann	name
ruthie	name
ruthe	name
ruthanne	name
ruthann	name
rutha	name
rushworth	name
rufina	name
rueben	name
rubye	name
rubie	name
rozanne	name
roxie	name
roxanne	name
roxanna	name
roxann	name
roxane	name
roxana	name
rossie	name
rossana	name
roslyn	name
rosita	name
rosio	name
rosina	name
rosia	name
rosendo	name
rosenda	name
rosena	name
rosemarie	name
roselyn	name
roselle	name
roseline	name
roselia	name
roselee	name
roseanne	name
roseanna	name
roseann	name
rosaura	name
rosanne	name
rosanna	name
rosann	name
rosana	name
rosamaria	name
rosalva	name
rosaline	name
rosalinda	name
rosalina	name
rosalia	name
rosalee	name
rosalba	name
rory	name
ronny	name
ronni	name
ronna	name
roni	name
rona	name
romona	name
romelia	name
rolland	name
rolande	name
rolanda	name
rogelio	name
rodrick	name
rodolfo	name
rodger	name
roderick	name
rocio	name
rochell	name
rochel	name
robyn	name
robt	name
robena	name
robbyn	name
robby	name
robbi	name
rivka	name
rita	name
risa	name
rina	name
rikki	name
rigoberto	name
ricky	name
rickie	name
ricki	name
richie	name
richelle	name
ricarda	name
rhona	name
rhiannon	name
rhett	name
rheba	name
reynaldo	name
reynalda	name
reyna	name
reyes	name
reva	name
retta	name
retha	name
reta	name
ressie	name
renna	name
renita	name
renetta	name
renea	name
renda	name
renay	name
renato	name
renata	name
renaldo	name
renae	name
remona	name
remedios	name
rema	name
reita	name
reinaldo	name
reina	name
reiko	name
reginia	name
regine	name
reggie	name
regenia	name
regena	name
regan	name
reena	name
reda	name
rebekah	name
rebecka	name
rebeca	name
rebbecca	name
rebbeca	name
reba	name
reatha	name
reanna	name
rayna	name
raymundo	name
raymonde	name
raymon	name
raylene	name
rayford	name
rashida	name
rasheeda	name
rashad	name
raquel	name
randi	name
randell	name
randee	name
randal	name
randa	name
ramonita	name
ramiro	name
raisa	name
raina	name
raguel	name
rafaela	name
raelene	name
raeann	name
racquel	name
rachelle	name
rachell	name
rachele	name
racheal	name
rachal	name
rachael	name
quyen	name
quinton	name
quintin	name
quiana	name
quentin	name
queenie	name
pura	name
providencia	name
priscila	name
pricilla	name
porsha	name
porfirio	name
pok	name
piedad	name
pia	name
phyliss	name
phylis	name
phylicia	name
phuong	name
phung	name
philomena	name
phillis	name
petronila	name
petrina	name
pennie	name
pei	name
peggie	name
pearline	name
pearlie	name
pearlene	name
pearle	name
paulita	name
paulina	name
pauletta	name
paulene	name
patrina	name
patrica	name
pasquale	name
particia	name
parthenia	name
paola	name
pamula	name
pamila	name
pamella	name
pamelia	name
pamala	name
paige	name
ozie	name
ozella	name
ozell	name
ouida	name
otilia	name
otha	name
otelia	name
oswaldo	name
osvaldo	name
orval	name
orpha	name
oretha	name
oralia	name
oralee	name
onita	name
onie	name
ollie	name
olimpia	name
olevia	name
oleta	name
olene	name
olen	name
ola	name
ofelia	name
odis	name
odilia	name
odette	name
odell	name
odelia	name
oda	name
octavio	name
ocie	name
obdulia	name
nyla	name
nydia	name
norine	name
noriko	name
norene	name
norberto	name
norah	name
noone	name
nohemi	name
noemi	name
noelle	name
noella	name
noelia	name
nobuko	name
nita	name
nisha	name
ninfa	name
nilsa	name
nilda	name
nila	name
nikole	name
nikki	name
nikita	name
nikia	name
niki	name
nigel	name
nieves	name
niesha	name
nidia	name
nicolle	name
nicolette	name
nicolasa	name
nicky	name
nickole	name
nickolas	name
nickie	name
nicki	name
nicholle	name
nichole	name
nichol	name
nichelle	name
nguyet	name
ngoc	name
ngan	name
nga	name
nettie	name
neta	name
nery	name
nerissa	name
nereida	name
neomi	name
neoma	name
nenita	name
nena	name
nelle	name
nella	name
nelida	name
nelia	name
nelda	name
neida	name
neely	name
nedra	name
neda	name
necole	name
natosha	name
natividad	name
natisha	name
nathanial	name
nathalie	name
natashia	name
natasha	name
natalya	name
natalia	name
natacha	name
narcisa	name
naoma	name
nannette	name
nancie	name
nanci	name
nancey	name
nancee	name
nakita	name
nakisha	name
nakia	name
nakesha	name
naida	name
nadene	name
nada	name
myung	name
myrtis	name
myrtie	name
myrtice	name
myrta	name
myrna	name
myrle	name
myrl	name
myriam	name
myong	name
myles	name
myesha	name
muoi	name
mui	name
mozelle	name
mozella	name
mozell	name
moshe	name
mose	name
moriah	name
monserrate	name
monnie	name
monique	name
moises	name
mohammad	name
miyoko	name
mitzie	name
mitzi	name
mittie	name
mitsuko	name
mitsue	name
mitchel	name
mistie	name
misha	name
mirtha	name
mirta	name
mirna	name
mirian	name
mireya	name
mirella	name
mireille	name
miquel	name
minta	name
mindy	name
mindi	name
minda	name
milly	name
millicent	name
milissa	name
milda	name
milagros	name
milagro	name
mikki	name
miki	name
mikel	name
mikaela	name
mika	name
miguelina	name
migdalia	name
miesha	name
micki	name
michiko	name
michell	name
michelina	name
micheal	name
michale	name
michal	name
michaele	name
michaela	name
micha	name
micaela	name
meryl	name
mertie	name
merrilee	name
merrie	name
merri	name
merna	name
merlyn	name
merlene	name
merissa	name
merilyn	name
meridith	name
merideth	name
mercedez	name
mendy	name
melynda	name
melvina	name
melva	name
melony	name
melonie	name
melodie	name
melodee	name
mellissa	name
mellisa	name
mellie	name
melissia	name
melisa	name
melina	name
melida	name
melia	name
melda	name
melany	name
melani	name
melaine	name
meghann	name
meghan	name
meggan	name
megan	name
meda	name
mechelle	name
meaghan	name
meagan	name
mazie	name
mayra	name
mayola	name
mayme	name
maybelle	name
maybell	name
maximo	name
maximina	name
maxie	name
mauro	name
maurita	name
maura	name
maudie	name
matilde	name
mathilde	name
mathilda	name
matha	name
masako	name
maryrose	name
marylynn	name
marylyn	name
marylouise	name
marylou	name
maryln	name
marylin	name
marylee	name
maryjo	name
maryjane	name
maryetta	name
maryellen	name
marybeth	name
marybelle	name
maryanne	name
maryanna	name
maryann	name
maryam	name
maryalice	name
marya	name
marvis	name
marvella	name
marva	name
marti	name
marth	name
marta	name
marquitta	name
marquita	name
marquetta	name
marquerite	name
marnie	name
marni	name
marna	name
marlys	name
marlyn	name
marlon	name
marlena	name
marlen	name
marleen	name
marlana	name
marla	name
markita	name
marketta	name
marivel	name
maritza	name
marisol	name
marisha	name
marisela	name
marisa	name
marinda	name
marilynn	name
marilu	name
marilou	name
marilee	name
mariko	name
mariette	name
marielle	name
mariella	name
mariela	name
mariel	name
maricruz	name
maricela	name
marica	name
maribeth	name
maribel	name
mariano	name
marianna	name
mariann	name
marianela	name
mariam	name
mariah	name
marhta	name
margy	name
margurite	name
marguerita	name
margrett	name
margret	name
margorie	name
margit	name
margie	name
margherita	name
marget	name
margert	name
margeret	name
margene	name
margart	name
margarito	name
margarette	name
margaretta	name
margarett	name
margareta	name
maren	name
mardell	name
marci	name
marchelle	name
marcene	name
marcelo	name
marcelle	name
marcella	name
marcell	name
marcelino	name
marcelina	name
marcelene	name
marcela	name
maranda	name
maragret	name
maragaret	name
manuela	name
mandy	name
mandie	name
mammie	name
malvina	name
malorie	name
mallie	name
malka	name
malissa	name
malisa	name
malinda	name
malika	name
malik	name
malia	name
malena	name
malcom	name
makeda	name
majorie	name
maisie	name
maisha	name
maira	name
maile	name
maida	name
mahalia	name
magda	name
magaret	name
magan	name
magaly	name
magali	name
mafalda	name
maegan	name
madlyn	name
madie	name
madge	name
madelyn	name
madelene	name
madelaine	name
maddie	name
madalyn	name
madaline	name
madalene	name
macie	name
machelle	name
mable	name
mabelle	name
lynwood	name
lynsey	name
lynnette	name
lynne	name
lynna	name
lynette	name
lynetta	name
lynelle	name
lynell	name
lyndsey	name
lyndsay	name
lyndia	name
lynda	name
lyn	name
lyla	name
lyda	name
luz	name
luvenia	name
lurline	name
lurlene	name
lupita	name
lula	name
luisa	name
luigi	name
luetta	name
ludivina	name
ludie	name
lucrecia	name
lucio	name
lucinda	name
lucilla	name
lucile	name
lucila	name
lucienne	name
lucie	name
luciano	name
luciana	name
luanne	name
luanna	name
luann	name
luana	name
loyd	name
loyce	name
lovie	name
lovetta	name
lovella	name
louvenia	name
lourie	name
loura	name
louie	name
louetta	name
louella	name
louanne	name
louann	name
lorrine	name
lorrie	name
lorriane	name
lorri	name
lorretta	name
lorita	name
lorine	name
lorina	name
lorilee	name
lorie	name
loriann	name
loria	name
loreta	name
lorenza	name
lorene	name
lorena	name
loreen	name
loree	name
lorean	name
loralee	name
loraine	name
lora	name
lonny	name
lonnie	name
lonna	name
loni	name
londa	name
lona	name
lon	name
loma	name
lolita	name
loise	name
loida	name
lizzette	name
lizette	name
lizeth	name
lizbeth	name
lizabeth	name
liza	name
livia	name
lita	name
lissette	name
lisha	name
lisbeth	name
lisandra	name
lisabeth	name
linwood	name
linnie	name
linnea	name
linh	name
lindsy	name
lina	name
lillie	name
lilliana	name
lilliam	name
lillia	name
lilli	name
lilla	name
liliana	name
lilia	name
lili	name
lieselotte	name
lidia	name
lida	name
librada	name
libbie	name
lianne	name
lezlie	name
letty	name
lettie	name
letisha	name
leticia	name
letha	name
leta	name
lessie	name
lesli	name
lesley	name
leslee	name
lesia	name
lesha	name
lesa	name
lera	name
leota	name
leora	name
leopoldo	name
leontine	name
leonore	name
leonor	name
leonila	name
leonie	name
leonida	name
leonia	name
leonel	name
leonarda	name
leoma	name
leola	name
lenora	name
lennie	name
lenna	name
lenita	name
lenard	name
lelia	name
lelah	name
lela	name
lekisha	name
leisha	name
leisa	name
leilani	name
leighann	name
leigha	name
leida	name
leia	name
leesa	name
leena	name
leeanne	name
leeanna	name
leeann	name
lecia	name
leatrice	name
leatha	name
leanora	name
leanne	name
leanna	name
leann	name
leandro	name
leandra	name
leana	name
lazaro	name
layne	name
layla	name
lawerence	name
lawanna	name
lawanda	name
lawana	name
lavonne	name
lavonna	name
lavonia	name
lavone	name
lavonda	name
lavona	name
lavon	name
lavinia	name
lavina	name
laveta	name
laverne	name
laverna	name
lavern	name
lavenia	name
lavelle	name
lavada	name
lauryn	name
laurine	name
laurinda	name
laurice	name
laurette	name
lauretta	name
laurene	name
laurena	name
laureen	name
lauran	name
lauralee	name
launa	name
latrisha	name
latricia	name
latrice	name
latoyia	name
latoya	name
latosha	name
latoria	name
latonya	name
latonia	name
latisha	name
laticia	name
latia	name
latesha	name
latashia	name
latasha	name
latarsha	name
latanya	name
lasonya	name
lashunda	name
lashonda	name
lashon	name
lashell	name
lashay	name
lashawnda	name
lashawna	name
lashawn	name
lashaunda	name
lashaun	name
lashandra	name
lashanda	name
lasandra	name
larue	name
larraine	name
laronda	name
larita	name
larissa	name
larhonda	name
laree	name
laraine	name
larae	name
laquita	name
laquanda	name
lanora	name
lanny	name
lannie	name
lanita	name
lanie	name
lani	name
lanette	name
lanelle	name
lanell	name
landon	name
lan	name
lamont	name
lamonica	name
lakita	name
lakisha	name
lakiesha	name
lakia	name
lakeshia	name
lakesha	name
lakenya	name
lakendra	name
lakeisha	name
lakeesha	name
lajuana	name
laila	name
lahoma	name
lael	name
ladonna	name
ladawn	name
lacresha	name
lacie	name
lachelle	name
kyung	name
kyra	name
kyong	name
kyoko	name
kymberly	name
kym	name
kylee	name
kyla	name
kurtis	name
krystyna	name
krystle	name
krystina	name
krystin	name
krysten	name
krystal	name
krysta	name
kristyn	name
kristy	name
kristopher	name
kristofer	name
kristle	name
kristine	name
kristie	name
kristian	name
kristi	name
kristen	name
kristel	name
kristeen	name
kristan	name
kristal	name
krista	name
krissy	name
kraig	name
kourtney	name
kory	name
kortney	name
kori	name
korey	name
klara	name
kizzy	name
kiyoko	name
kittie	name
kisha	name
kirstin	name
kirstie	name
kirsten	name
kira	name
kindra	name
kimiko	name
kimi	name
kimbra	name
kimbery	name
kimberlie	name
kimberli	name
kimberlee	name
kimberely	name
kimber	name
kiley	name
kieth	name
kiesha	name
kiersten	name
kiera	name
kiara	name
kiana	name
kia	name
khalilah	name
khadijah	name
keven	name
keva	name
keturah	name
keshia	name
kesha	name
kerstin	name
kerrie	name
kerri	name
keri	name
kera	name
kenyetta	name
kennith	name
kenna	name
kenisha	name
keneth	name
kendrick	name
kendra	name
kenda	name
kena	name
kemberly	name
kelsie	name
kelsi	name
kellye	name
kellie	name
kelli	name
kellee	name
kelle	name
keli	name
keitha	name
keisha	name
keira	name
keila	name
keiko	name
keesha	name
keena	name
keely	name
keeley	name
kecia	name
kazuko	name
kaylene	name
kayleigh	name
kayleen	name
kaylee	name
kayla	name
kaye	name
kaycee	name
kayce	name
katy	name
kattie	name
katrice	name
katlyn	name
katina	name
katia	name
kati	name
kathyrn	name
kathryne	name
kathryn	name
kathrine	name
kathrin	name
kathlyn	name
kathline	name
kathlene	name
kathie	name
kathi	name
kathey	name
katheryn	name
kathern	name
katherina	name
katherin	name
katheleen	name
kathe	name
katharyn	name
kathaleen	name
katerine	name
katelynn	name
katelyn	name
katelin	name
kassie	name
kassandra	name
kasie	name
kasi	name
kasey	name
kasandra	name
karyn	name
karyl	name
kary	name
karry	name
karrie	name
karren	name
karon	name
karolyn	name
karoline	name
karole	name
karlyn	name
karly	name
karlene	name
karleen	name
karla	name
karissa	name
karisa	name
karine	name
karina	name
karima	name
karie	name
karey	name
karena	name
kareen	name
kareem	name
karan	name
kanisha	name
kanesha	name
kandra	name
kandis	name
kandice	name
kandi	name
kandace	name
kamilah	name
kalyn	name
kallie	name
kaley	name
kaleigh	name
kaitlyn	name
kaitlin	name
kaila	name
kai	name
kacy	name
kacie	name
kaci	name
kacey	name
justina	name
junko	name
junita	name
junie	name
julissa	name
juliette	name
julietta	name
julieta	name
julieann	name
julianne	name
julianna	name
juliann	name
juliane	name
julene	name
julee	name
jule	name
judi	name
juana	name
joycelyn	name
joya	name
jovita	name
jovan	name
josue	name
josphine	name
jospeh	name
joslyn	name
josie	name
josette	name
josephina	name
joselyn	name
josefine	name
josefina	name
josefa	name
jordon	name
jonnie	name
jonna	name
jonie	name
joni	name
jonelle	name
jonell	name
jone	name
jonathon	name
jona	name
jolynn	name
jolyn	name
joline	name
jolene	name
joleen	name
jolanda	name
joi	name
johnsie	name
johnna	name
johnie	name
johnette	name
johnetta	name
johnathon	name
johnathan	name
johna	name
johana	name
joette	name
joetta	name
joesph	name
joellen	name
joelle	name
joella	name
joeann	name
jodie	name
jodee	name
jocelyn	name
joaquina	name
joannie	name
joann	name
joanie	name
joane	name
joana	name
jina	name
jin	name
jillian	name
jettie	name
jetta	name
jesusita	name
jesusa	name
jestine	name
jessika	name
jessia	name
jessi	name
jessenia	name
jesica	name
jesenia	name
jerrold	name
jerrod	name
jerrie	name
jerrica	name
jerri	name
jerrell	name
jeromy	name
jerold	name
jermaine	name
jerlene	name
jerilyn	name
jerica	name
jeri	name
jere	name
jeramy	name
jeraldine	name
jerald	name
jennine	name
jenniffer	name
jenni	name
jennette	name
jennell	name
jennefer	name
jenna	name
jenise	name
jenine	name
jeniffer	name
jenifer	name
jenice	name
jeni	name
jeneva	name
jenette	name
jenelle	name
jenell	name
jenee	name
jenae	name
jen	name
jeffry	name
jeffie	name
jeffery	name
jefferey	name
jeannine	name
jeannetta	name
jeanna	name
jeanmarie	name
jeanine	name
jeanice	name
jeanetta	name
jeanett	name
jeanene	name
jeanelle	name
jeane	name
jeana	name
jc	name
jazmine	name
jazmin	name
jayson	name
jayne	name
jayna	name
jaymie	name
jayme	name
jaye	name
javier	name
jaunita	name
jarrod	name
jarrett	name
jarod	name
jaquelyn	name
jaqueline	name
janyce	name
jannie	name
jannette	name
jannet	name
janna	name
jann	name
janita	name
janise	name
janine	name
janiece	name
jani	name
janey	name
janette	name
janetta	name
janett	name
janeth	name
janessa	name
janene	name
janelle	name
janella	name
janell	name
janel	name
janeen	name
janee	name
janean	name
janay	name
janae	name
jammie	name
jamison	name
jamila	name
jamika	name
jami	name
jamey	name
jamel	name
jamee	name
jame	name
jamar	name
jamal	name
jamaal	name
jama	name
jalisa	name
jaleesa	name
jaimie	name
jaimee	name
jae	name
jadwiga	name
jada	name
jacqulyn	name
jacquline	name
jacquiline	name
jacquie	name
jacqui	name
jacquetta	name
jacquelynn	name
jacquelyne	name
jacquelyn	name
jacquelin	name
jacqualine	name
jaclyn	name
jackqueline	name
jacklyn	name
jacki	name
jackelyn	name
jackeline	name
jacinto	name
jacinta	name
jacinda	name
jacelyn	name
jacalyn	name
izola	name
izetta	name
ivonne	name
ivey	name
ivette	name
ivelisse	name
ivana	name
iva	name
issac	name
isobel	name
isidro	name
isidra	name
isiah	name
isela	name
isaura	name
isaias	name
isadora	name
isabell	name
irena	name
iraida	name
iola	name
inocencia	name
inger	name
inga	name
inez	name
ines	name
inell	name
imogene	name
imelda	name
iluminada	name
iliana	name
ilene	name
ileen	name
ileana	name
ilda	name
ilana	name
ila	name
ignacio	name
ignacia	name
iesha	name
idella	name
idell	name
idalia	name
hyun	name
hyon	name
hyo	name
hwa	name
huong	name
humberto	name
hulda	name
hsiu	name
hortencia	name
horacio	name
hollis	name
hollie	name
holli	name
holley	name
hobert	name
hoa	name
hisako	name
hiroko	name
hipolito	name
hilma	name
hildred	name
hildegarde	name
hilda	name
hilario	name
hilaria	name
hien	name
hiedi	name
herta	name
herminia	name
hermina	name
hermila	name
hermelinda	name
herlinda	name
heriberto	name
henriette	name
helaine	name
heidy	name
heide	name
hedy	name
hedwig	name
hayley	name
haydee	name
hassie	name
harriette	name
harriett	name
harland	name
hanh	name
hana	name
hallie	name
halina	name
hailey	name
gwyneth	name
gwenn	name
gwendolyn	name
gwenda	name
gussie	name
guillermo	name
guillermina	name
griselda	name
grisel	name
gricelda	name
gretta	name
gregorio	name
gregoria	name
grazyna	name
grayce	name
graig	name
graciela	name
gonzalo	name
goldie	name
glynis	name
glynda	name
glinda	name
glenroy	name
glennis	name
glennie	name
glenna	name
glendora	name
glayds	name
gladis	name
giuseppina	name
gita	name
gisele	name
giovanna	name
ginny	name
ginette	name
gilma	name
gillian	name
gilberto	name
gilberte	name
gigi	name
gidget	name
gianna	name
gia	name
ghislaine	name
gertude	name
gertrudis	name
gertie	name
gertha	name
gerri	name
geri	name
gerardo	name
geralyn	name
geraldo	name
georgine	name
georgina	name
georgie	name
georgianne	name
georgianna	name
georgiann	name
georgiana	name
georgetta	name
georgene	name
georgeanna	name
georgeann	name
georgann	name
genoveva	name
genny	name
gennie	name
genna	name
genia	name
genevive	name
genevie	name
genaro	name
gema	name
gearldine	name
gaynelle	name
gaynell	name
gaylene	name
gayle	name
gayla	name
gaye	name
galina	name
gabriella	name
gabriela	name
fumiko	name
frieda	name
frida	name
freeda	name
fredricka	name
fredric	name
fredia	name
fredericka	name
fredda	name
fransisca	name
franklyn	name
francisca	name
francina	name
franchesca	name
francene	name
floy	name
flossie	name
florrie	name
florine	name
florinda	name
floria	name
floretta	name
florentino	name
florentina	name
florene	name
florencio	name
florencia	name
florance	name
fleta	name
flavia	name
fiona	name
filomena	name
filiberto	name
fidela	name
fernande	name
fernanda	name
fermina	name
fermin	name
felton	name
felisha	name
felisa	name
felipe	name
felipa	name
felicita	name
felicidad	name
felica	name
felecia	name
federico	name
faye	name
faviola	name
fausto	name
faustino	name
faustina	name
fatimah	name
farrah	name
farah	name
fannie	name
fallon	name
fae	name
fabiola	name
ezequiel	name
exie	name
ewa	name
evonne	name
evon	name
evita	name
evie	name
evia	name
evette	name
everette	name
evelynn	name
evelyne	name
eveline	name
evelina	name
evelin	name
evelia	name
evangelina	name
evalyn	name
eustolia	name
eusebio	name
eusebia	name
eura	name
euna	name
eun	name
eulalia	name
eulah	name
eula	name
eugenio	name
eugenie	name
eugena	name
eufemia	name
ettie	name
etta	name
etsuko	name
ethelyn	name
ethelene	name
etha	name
estrella	name
estelle	name
estell	name
estela	name
estefana	name
esteban	name
essie	name
esperanza	name
esmeralda	name
eryn	name
ernesto	name
ernestina	name
erminia	name
ermelinda	name
erma	name
erline	name
erlinda	name
erlene	name
erinn	name
ericka	name
erasmo	name
epifania	name
enriqueta	name
enrique	name
enola	name
eneida	name
enedina	name
enda	name
ena	name
emogene	name
emmitt	name
emmie	name
emmaline	name
emilie	name
emilia	name
emilee	name
emiko	name
emely	name
emeline	name
emelina	name
emelia	name
emelda	name
ema	name
elza	name
elyse	name
elwanda	name
elvina	name
elvin	name
elvie	name
elvia	name
elvera	name
elva	name
elsy	name
elsa	name
eloy	name
elouise	name
eloisa	name
elois	name
elodia	name
elnora	name
elna	name
elmo	name
elma	name
ellyn	name
elly	name
elli	name
ellena	name
ellan	name
ellamae	name
elizebeth	name
elizbeth	name
elizabet	name
eliz	name
elissa	name
eliseo	name
elisa	name
elinore	name
elina	name
elin	name
elidia	name
elida	name
elicia	name
eliana	name
elfrieda	name
elfreda	name
eleonore	name
eleonora	name
eleonor	name
elenore	name
elenora	name
elenor	name
eleni	name
elene	name
elease	name
eleanore	name
eleanora	name
eldridge	name
eldora	name
elden	name
elda	name
elayne	name
elanor	name
elane	name
elana	name
elaina	name
eladia	name
ela	name
eilene	name
ehtel	name
efren	name
efrain	name
edythe	name
edyth	name
edwardo	name
edris	name
edra	name
edmundo	name
edmond	name
edie	name
edgardo	name
edelmira	name
eda	name
ebonie	name
eboni	name
eartha	name
earnestine	name
earline	name
earlie	name
earlene	name
earleen	name
earlean	name
dyan	name
dwayne	name
dwana	name
dwain	name
dusti	name
dulcie	name
drusilla	name
drucilla	name
drema	name
dreama	name
dovie	name
dottie	name
dorthy	name
dorthey	name
dorthea	name
dortha	name
dorsey	name
dorris	name
dorotha	name
dorla	name
dorine	name
dorinda	name
dorie	name
dori	name
doretta	name
dorethea	name
doretha	name
dorene	name
doreatha	name
dorathy	name
donya	name
donte	name
donnie	name
donnette	name
donnetta	name
donnell	name
donn	name
donita	name
donette	name
donetta	name
donella	name
domonique	name
domitila	name
dominque	name
dominga	name
domenica	name
domenic	name
dollie	name
dodie	name
dionne	name
dionna	name
dinorah	name
dino	name
dierdre	name
diedra	name
didnt	name
dianna	name
diann	name
dian	name
dewayne	name
devorah	name
devora	name
devona	name
detra	name
dessie	name
despina	name
desiree	name
desirae	name
deshawn	name
derick	name
deonna	name
denyse	name
dennise	name
denna	name
denita	name
denisse	name
denisha	name
denise	name
denice	name
denese	name
denae	name
dena	name
demetrius	name
demetrice	name
demetria	name
demetra	name
demarcus	name
delsie	name
delphia	name
delpha	name
delorse	name
deloris	name
delores	name
deloras	name
delora	name
deloise	name
delois	name
delmy	name
delmer	name
delma	name
delisa	name
delinda	name
delila	name
delfina	name
delena	name
delcie	name
delbert	name
delana	name
deidre	name
deidra	name
deetta	name
deena	name
deedra	name
deedee	name
deeanna	name
deeann	name
dedra	name
dede	name
debroah	name
debrah	name
debora	name
debi	name
debera	name
debbra	name
debbi	name
deanne	name
deann	name
deangelo	name
deandrea	name
deandre	name
deandra	name
deana	name
deadra	name
daysi	name
dayna	name
dayle	name
dawne	name
dawna	name
davina	name
davida	name
darryl	name
darron	name
darrin	name
darrick	name
darren	name
darrel	name
darnell	name
darline	name
darlena	name
darleen	name
darla	name
daria	name
daren	name
darell	name
darcie	name
darci	name
darcey	name
darcel	name
dara	name
danyelle	name
danyell	name
danyel	name
danuta	name
dannielle	name
dannie	name
dannette	name
danna	name
danita	name
danilo	name
danille	name
danika	name
danielle	name
daniella	name
daniele	name
daniela	name
danica	name
danial	name
dania	name
dani	name
danette	name
danelle	name
danae	name
damion	name
damian	name
damaris	name
dalila	name
dalene	name
daisey	name
daina	name
dagny	name
dagmar	name
cythia	name
cyrstal	name
cyndy	name
cyndi	name
crystle	name
crysta	name
cristy	name
cristopher	name
cristobal	name
cristine	name
cristina	name
cristin	name
cristie	name
cristen	name
crissy	name
criselda	name
creola	name
cory	name
cortney	name
corrinne	name
corrine	name
corrina	name
corrin	name
corliss	name
corinne	name
corinna	name
corine	name
corina	name
corie	name
coretta	name
corene	name
coreen	name
cordie	name
cordell	name
cordelia	name
corazon	name
coralie	name
coralee	name
contessa	name
consuelo	name
consuela	name
concetta	name
colton	name
collin	name
collene	name
collen	name
coletta	name
colene	name
coleen	name
codi	name
clotilde	name
clorinda	name
clora	name
cletus	name
cleta	name
cleotilde	name
cleora	name
cleo	name
clemmie	name
clemencia	name
clelia	name
claudine	name
claudie	name
claudette	name
classie	name
clarita	name
clarisa	name
claris	name
clarinda	name
clarice	name
claribel	name
claretta	name
claretha	name
cinthia	name
cindie	name
cindi	name
cinda	name
cierra	name
ciera	name
ciara	name
chun	name
christoper	name
christinia	name
christin	name
christia	name
christene	name
christena	name
christeen	name
christal	name
chrissy	name
chong	name
chiquita	name
chieko	name
chet	name
cheryll	name
cheryle	name
chery	name
cherryl	name
cherrie	name
cherri	name
cherlyn	name
cherly	name
cherise	name
cherilyn	name
cherie	name
cheri	name
cherelle	name
cheree	name
chelsie	name
chelsey	name
chaya	name
chau	name
chassidy	name
chasity	name
chasidy	name
charolette	name
charmaine	name
charmain	name
charlyn	name
charlsie	name
charlott	name
charline	name
charlette	name
charlesetta	name
charlene	name
charlena	name
charleen	name
charla	name
charita	name
charisse	name
charissa	name
charise	name
charis	name
chantelle	name
chantell	name
chantel	name
chantay	name
chantal	name
chanelle	name
chanell	name
chandra	name
chanda	name
chana	name
chan	name
chae	name
cesar	name
ceola	name
celine	name
celinda	name
celina	name
celestine	name
celena	name
cedrick	name
cecille	name
cecile	name
cecila	name
cecelia	name
cayla	name
catrina	name
catrice	name
catina	name
cathryn	name
cathrine	name
cathleen	name
cathie	name
cathi	name
cathey	name
catheryn	name
cathern	name
catherina	name
catherin	name
caterina	name
catarina	name
cassy	name
cassondra	name
cassie	name
cassidy	name
cassey	name
cassaundra	name
casimira	name
casie	name
casandra	name
caryn	name
carylon	name
caryl	name
caroyln	name
caron	name
carolynn	name
carolyne	name
caroll	name
carolin	name
carolee	name
carolann	name
carola	name
carmon	name
carmelo	name
carmella	name
carmelita	name
carmelina	name
carmelia	name
carma	name
carlyn	name
carly	name
carlotta	name
carlita	name
carlie	name
carli	name
carley	name
carletta	name
carlene	name
carlena	name
carleen	name
carlee	name
carita	name
carin	name
caridad	name
caren	name
cara	name
candyce	name
candra	name
candice	name
candelaria	name
candance	name
cammy	name
cammie	name
camila	name
camie	name
callie	name
calista	name
calandra	name
caitlyn	name
caitlin	name
bulah	name
bula	name
buford	name
brynn	name
bryanna	name
brunilda	name
bronwyn	name
broderick	name
brittny	name
brittni	name
brittney	name
britteny	name
brittanie	name
brittani	name
brittaney	name
britta	name
britt	name
britni	name
britney	name
brinda	name
brigida	name
brigette	name
bridgette	name
bridgett	name
brianne	name
brianna	name
briana	name
bret	name
brenton	name
brenna	name
brendon	name
breanne	name
breanna	name
breann	name
breana	name
brandee	name
branda	name
bradly	name
bonita	name
bok	name
bobette	name
bobbye	name
bobbi	name
blondell	name
blanca	name
billye	name
billi	name
bianca	name
beverlee	name
bev	name
beula	name
bettye	name
bettyann	name
bettina	name
bettie	name
bethann	name
bethanie	name
berta	name
bernita	name
bernetta	name
berneice	name
bernardina	name
bernarda	name
berenice	name
bennie	name
benito	name
benita	name
benbowie	name
belva	name
belkis	name
belia	name
belen	name
beckie	name
becki	name
bebe	name
beaulah	name
beatriz	name
beatris	name
basilia	name
barbra	name
barbie	name
barbar	name
barabara	name
bao	name
babette	name
babara	name
azzie	name
azucena	name
azalee	name
ayanna	name
ayana	name
ayako	name
awilda	name
avelina	name
aurelio	name
aurelia	name
aundrea	name
augustina	name
audry	name
audrie	name
audria	name
audrea	name
audra	name
audie	name
astrid	name
assunta	name
asley	name
ashlyn	name
ashly	name
ashlie	name
ashli	name
ashleigh	name
ashlee	name
ashlea	name
ashely	name
asha	name
arvilla	name
arron	name
arnulfo	name
arnoldo	name
arnita	name
arnette	name
arnetta	name
arminda	name
armida	name
armando	name
armandina	name
armanda	name
armand	name
arlyne	name
arline	name
arlinda	name
arlie	name
arlette	name
arletta	name
arletha	name
arlena	name
arleen	name
arlean	name
arla	name
arielle	name
arie	name
arianne	name
arianna	name
ariana	name
argelia	name
aretha	name
ardith	name
ardis	name
ardelle	name
ardella	name
ardell	name
ardelia	name
ardath	name
arcelia	name
aracely	name
aracelis	name
araceli	name
apryl	name
apolonia	name
anya	name
antwan	name
antonina	name
antonietta	name
antonia	name
antonette	name
antonetta	name
antone	name
antionette	name
antione	name
annmarie	name
annita	name
annis	name
annika	name
annice	name
annetta	name
annett	name
annemarie	name
annelle	name
annamarie	name
annamaria	name
annamae	name
annalisa	name
annalee	name
annabelle	name
annabell	name
anjelica	name
anjanette	name
anitra	name
anissa	name
anisha	name
anisa	name
anika	name
anibal	name
anh	name
anglea	name
angla	name
angila	name
angelyn	name
angella	name
angelita	name
angelique	name
angelia	name
angelena	name
angele	name
anette	name
andria	name
andree	name
andra	name
andera	name
anastacia	name
anamaria	name
analisa	name
amparo	name
ammie	name
amira	name
amina	name
amiee	name
amee	name
amberly	name
amalia	name
amal	name
amado	name
amada	name
alyson	name
alysia	name
alysha	name
alyse	name
alysa	name
alycia	name
alyce	name
alvina	name
alverta	name
alvera	name
alvaro	name
altha	name
altagracia	name
alphonso	name
alonso	name
alona	name
almeta	name
almeda	name
allyson	name
alline	name
allene	name
allena	name
aliza	name
alix	name
alissa	name
alisia	name
alishia	name
alisha	name
alisa	name
alina	name
alida	name
alfredia	name
alfreda	name
alfonzo	name
alexa	name
alethia	name
alethea	name
aletha	name
aleta	name
alessandra	name
alesia	name
aleshia	name
alesha	name
alene	name
alena	name
alejandro	name
alejandrina	name
alejandra	name
aleisha	name
aleida	name
aleen	name
alecia	name
alease	name
aldo	name
alda	name
albina	name
albertina	name
albertha	name
alayna	name
alanna	name
alane	name
alana	name
alaine	name
alaina	name
akilah	name
akiko	name
aja	name
aimee	name
ailene	name
aiko	name
ahmed	name
ahmad	name
agustina	name
agustin	name
agueda	name
agripina	name
afton	name
adriene	name
adrien	name
adrianne	name
adrianna	name
adriane	name
adriana	name
adria	name
adolfo	name
adj	name
adina	name
adena	name
adelle	name
adella	name
adell	name
adelina	name
adelaida	name
adela	name
addie	name
adan	name
adaline	name
adalberto	name
adah	name
abst	name
abdul	name
abbie	name
can	modalauxiliary
may	modalauxiliary
will	modalauxiliary
shall	modalauxiliary
must	modalauxiliary
ought	modalauxiliary
could	modalauxiliary
might	modalauxiliary
would	modalauxiliary
should	modalauxiliary
only	englishfunction
many	englishfunction
very	englishfunction
most	englishfunction
because	englishfunction
also	englishfunction
does	auxiliary
do	auxiliary
ment	ocr
pt	bibliography
ch	bibliography
